,image_name,x_1,y_1,x_2,y_2,category,category_type,category_type_name,width,height,area,evaluation_status,category_encoding
8184,img/Zip_Collar_Bomber/img_00000001.jpg,22,80,239,290,Bomber,1,Upper Body,217,210,45570,train,1
8185,img/Zip_Collar_Bomber/img_00000002.jpg,50,38,254,273,Bomber,1,Upper Body,204,235,47940,train,1
8186,img/Zip_Collar_Bomber/img_00000003.jpg,13,14,193,198,Bomber,1,Upper Body,180,184,33120,train,1
8187,img/Zip_Collar_Bomber/img_00000004.jpg,69,53,248,273,Bomber,1,Upper Body,179,220,39380,train,1
8188,img/Zip_Collar_Bomber/img_00000005.jpg,29,2,175,212,Bomber,1,Upper Body,146,210,30660,train,1
8190,img/Zip_Collar_Bomber/img_00000007.jpg,21,3,177,213,Bomber,1,Upper Body,156,210,32760,train,1
8191,img/Zip_Collar_Bomber/img_00000008.jpg,90,49,212,222,Bomber,1,Upper Body,122,173,21106,train,1
8192,img/Zip_Collar_Bomber/img_00000009.jpg,38,58,136,267,Bomber,1,Upper Body,98,209,20482,train,1
8194,img/Zip_Collar_Bomber/img_00000011.jpg,27,58,224,300,Bomber,1,Upper Body,197,242,47674,train,1
8196,img/Zip_Collar_Bomber/img_00000013.jpg,20,16,240,267,Bomber,1,Upper Body,220,251,55220,train,1
8197,img/Zip_Collar_Bomber/img_00000014.jpg,31,31,225,221,Bomber,1,Upper Body,194,190,36860,train,1
8198,img/Zip_Collar_Bomber/img_00000015.jpg,92,55,217,201,Bomber,1,Upper Body,125,146,18250,train,1
8200,img/Zip_Collar_Bomber/img_00000017.jpg,25,59,179,241,Bomber,1,Upper Body,154,182,28028,train,1
8201,img/Zip_Collar_Bomber/img_00000018.jpg,55,59,242,300,Bomber,1,Upper Body,187,241,45067,train,1
8202,img/Zip_Collar_Bomber/img_00000019.jpg,28,59,228,300,Bomber,1,Upper Body,200,241,48200,train,1
8203,img/Zip_Collar_Bomber/img_00000020.jpg,58,77,195,279,Bomber,1,Upper Body,137,202,27674,train,1
8206,img/Zip_Collar_Bomber/img_00000023.jpg,37,72,219,300,Bomber,1,Upper Body,182,228,41496,train,1
8207,img/Zip_Collar_Bomber/img_00000024.jpg,1,53,164,279,Bomber,1,Upper Body,163,226,36838,train,1
8209,img/Zip_Collar_Bomber/img_00000026.jpg,33,55,221,300,Bomber,1,Upper Body,188,245,46060,train,1
8210,img/Zip_Collar_Bomber/img_00000027.jpg,27,46,173,262,Bomber,1,Upper Body,146,216,31536,train,1
8211,img/Zip_Collar_Bomber/img_00000028.jpg,11,1,192,218,Bomber,1,Upper Body,181,217,39277,train,1
8212,img/Zip_Collar_Bomber/img_00000029.jpg,20,15,240,267,Bomber,1,Upper Body,220,252,55440,train,1
8213,img/Zip_Collar_Bomber/img_00000030.jpg,50,21,223,234,Bomber,1,Upper Body,173,213,36849,train,1
8214,img/Zip_Collar_Bomber/img_00000031.jpg,24,43,196,261,Bomber,1,Upper Body,172,218,37496,train,1
8215,img/Zip_Collar_Bomber/img_00000032.jpg,21,12,202,244,Bomber,1,Upper Body,181,232,41992,train,1
8216,img/Zip_Collar_Bomber/img_00000033.jpg,11,72,183,288,Bomber,1,Upper Body,172,216,37152,train,1
8217,img/Zip_Collar_Bomber/img_00000034.jpg,23,42,183,285,Bomber,1,Upper Body,160,243,38880,train,1
8219,img/Zip_Collar_Bomber/img_00000036.jpg,19,52,183,250,Bomber,1,Upper Body,164,198,32472,train,1
8220,img/Zip_Collar_Bomber/img_00000037.jpg,44,23,208,246,Bomber,1,Upper Body,164,223,36572,train,1
8221,img/Zip_Collar_Bomber/img_00000038.jpg,48,64,233,300,Bomber,1,Upper Body,185,236,43660,train,1
8223,img/Zip_Collar_Bomber/img_00000040.jpg,10,46,206,274,Bomber,1,Upper Body,196,228,44688,train,1
8224,img/Zip_Collar_Bomber/img_00000041.jpg,47,68,168,245,Bomber,1,Upper Body,121,177,21417,train,1
8225,img/Zip_Collar_Bomber/img_00000042.jpg,25,1,221,271,Bomber,1,Upper Body,196,270,52920,train,1
8226,img/Zip_Collar_Bomber/img_00000043.jpg,25,64,197,251,Bomber,1,Upper Body,172,187,32164,train,1
8227,img/Zip_Collar_Bomber/img_00000044.jpg,65,37,226,283,Bomber,1,Upper Body,161,246,39606,train,1
8228,img/Zip_Collar_Bomber/img_00000045.jpg,42,53,206,268,Bomber,1,Upper Body,164,215,35260,train,1
8229,img/Zip_Collar_Bomber/img_00000046.jpg,47,45,250,274,Bomber,1,Upper Body,203,229,46487,train,1
8231,img/Zip_Collar_Bomber/img_00000048.jpg,4,52,197,300,Bomber,1,Upper Body,193,248,47864,train,1
8232,img/Zip_Collar_Bomber/img_00000049.jpg,28,53,180,263,Bomber,1,Upper Body,152,210,31920,train,1
8233,img/Zip_Collar_Bomber/img_00000050.jpg,22,44,174,217,Bomber,1,Upper Body,152,173,26296,train,1
8235,img/Zip_Collar_Bomber/img_00000052.jpg,1,32,143,209,Bomber,1,Upper Body,142,177,25134,train,1
8236,img/Zip_Collar_Bomber/img_00000053.jpg,92,74,242,278,Bomber,1,Upper Body,150,204,30600,train,1
8237,img/Zip_Collar_Bomber/img_00000054.jpg,35,51,165,225,Bomber,1,Upper Body,130,174,22620,train,1
8239,img/Zip_Collar_Bomber/img_00000056.jpg,45,64,206,262,Bomber,1,Upper Body,161,198,31878,train,1
8240,img/Zip_Collar_Bomber/img_00000057.jpg,24,7,190,234,Bomber,1,Upper Body,166,227,37682,train,1
8242,img/Zip_Collar_Bomber/img_00000059.jpg,1,1,196,245,Bomber,1,Upper Body,195,244,47580,train,1
8243,img/Zip_Collar_Bomber/img_00000060.jpg,28,54,177,253,Bomber,1,Upper Body,149,199,29651,train,1
8244,img/Zip_Collar_Bomber/img_00000061.jpg,57,78,171,258,Bomber,1,Upper Body,114,180,20520,train,1
8245,img/Zip_Collar_Bomber/img_00000062.jpg,33,66,190,245,Bomber,1,Upper Body,157,179,28103,train,1
8247,img/Zip_Collar_Bomber/img_00000064.jpg,70,76,221,262,Bomber,1,Upper Body,151,186,28086,train,1
8248,img/Zip_Collar_Bomber/img_00000065.jpg,69,48,151,156,Bomber,1,Upper Body,82,108,8856,train,1
8250,img/Zip_Collar_Bomber/img_00000067.jpg,90,53,206,235,Bomber,1,Upper Body,116,182,21112,train,1
8251,img/Zip_Collar_Bomber/img_00000068.jpg,1,63,144,276,Bomber,1,Upper Body,143,213,30459,train,1
8252,img/Zip_Collar_Bomber/img_00000069.jpg,20,71,178,269,Bomber,1,Upper Body,158,198,31284,train,1
8254,img/Zip_Collar_Bomber/img_00000071.jpg,25,52,183,260,Bomber,1,Upper Body,158,208,32864,train,1
8255,img/Zip_Collar_Bomber/img_00000072.jpg,14,53,130,195,Bomber,1,Upper Body,116,142,16472,train,1
8256,img/Zip_Collar_Bomber/img_00000073.jpg,16,59,195,300,Bomber,1,Upper Body,179,241,43139,train,1
8259,img/Zip_Collar_Bomber/img_00000076.jpg,21,77,196,288,Bomber,1,Upper Body,175,211,36925,train,1
8260,img/Zip_Collar_Bomber/img_00000077.jpg,43,51,170,235,Bomber,1,Upper Body,127,184,23368,train,1
8261,img/Zip_Collar_Bomber/img_00000078.jpg,11,44,132,200,Bomber,1,Upper Body,121,156,18876,train,1
8262,img/Zip_Collar_Bomber/img_00000079.jpg,33,63,206,258,Bomber,1,Upper Body,173,195,33735,train,1
8264,img/Zip_Collar_Bomber/img_00000081.jpg,40,53,201,281,Bomber,1,Upper Body,161,228,36708,train,1
8265,img/Zip_Collar_Bomber/img_00000082.jpg,25,55,210,286,Bomber,1,Upper Body,185,231,42735,train,1
8266,img/Zip_Collar_Bomber/img_00000083.jpg,24,69,218,295,Bomber,1,Upper Body,194,226,43844,train,1
8268,img/Zip_Collar_Bomber/img_00000085.jpg,29,70,189,288,Bomber,1,Upper Body,160,218,34880,train,1
8270,img/Zip_Collar_Bomber/img_00000087.jpg,29,45,196,286,Bomber,1,Upper Body,167,241,40247,train,1
8271,img/Zip_Collar_Bomber/img_00000088.jpg,51,71,179,193,Bomber,1,Upper Body,128,122,15616,train,1
8272,img/Zip_Collar_Bomber/img_00000089.jpg,18,64,203,271,Bomber,1,Upper Body,185,207,38295,train,1
8273,img/Zip_Collar_Bomber/img_00000090.jpg,29,65,216,300,Bomber,1,Upper Body,187,235,43945,train,1
8274,img/Zip_Collar_Bomber/img_00000091.jpg,31,39,161,265,Bomber,1,Upper Body,130,226,29380,train,1
8275,img/Zip_Collar_Bomber/img_00000092.jpg,26,63,219,292,Bomber,1,Upper Body,193,229,44197,train,1
8276,img/Zip_Collar_Bomber/img_00000093.jpg,43,59,173,286,Bomber,1,Upper Body,130,227,29510,train,1
8277,img/Zip_Collar_Bomber/img_00000094.jpg,54,61,212,281,Bomber,1,Upper Body,158,220,34760,train,1
8278,img/Zip_Collar_Bomber/img_00000095.jpg,31,54,216,296,Bomber,1,Upper Body,185,242,44770,train,1
8279,img/Zip_Collar_Bomber/img_00000096.jpg,64,47,146,156,Bomber,1,Upper Body,82,109,8938,train,1
8280,img/Zip_Collar_Bomber/img_00000097.jpg,12,14,204,249,Bomber,1,Upper Body,192,235,45120,train,1
8281,img/Zip_Collar_Bomber/img_00000098.jpg,31,56,204,274,Bomber,1,Upper Body,173,218,37714,train,1
8283,img/Zip_Collar_Bomber/img_00000100.jpg,32,37,124,199,Bomber,1,Upper Body,92,162,14904,train,1
8284,img/Zip_Collar_Bomber/img_00000101.jpg,9,77,225,300,Bomber,1,Upper Body,216,223,48168,train,1
8286,img/Zip_Collar_Bomber/img_00000103.jpg,31,44,175,252,Bomber,1,Upper Body,144,208,29952,train,1
8288,img/Zip_Collar_Bomber/img_00000105.jpg,25,61,179,259,Bomber,1,Upper Body,154,198,30492,train,1
8289,img/Zip_Collar_Bomber/img_00000106.jpg,18,53,124,200,Bomber,1,Upper Body,106,147,15582,train,1
8290,img/Zip_Collar_Bomber/img_00000107.jpg,34,57,171,255,Bomber,1,Upper Body,137,198,27126,train,1
8292,img/Zip_Collar_Bomber/img_00000109.jpg,51,63,196,252,Bomber,1,Upper Body,145,189,27405,train,1
8293,img/Zip_Collar_Bomber/img_00000110.jpg,17,36,120,159,Bomber,1,Upper Body,103,123,12669,train,1
8294,img/Zip_Collar_Bomber/img_00000111.jpg,22,54,174,243,Bomber,1,Upper Body,152,189,28728,train,1
8298,img/Zip_Collar_Bomber/img_00000115.jpg,19,62,200,268,Bomber,1,Upper Body,181,206,37286,train,1
8299,img/Zip_Collar_Bomber/img_00000116.jpg,22,61,214,280,Bomber,1,Upper Body,192,219,42048,train,1
8300,img/Zip_Collar_Bomber/img_00000117.jpg,18,15,227,236,Bomber,1,Upper Body,209,221,46189,train,1
8303,img/Zip_Collar_Bomber/img_00000120.jpg,17,67,202,271,Bomber,1,Upper Body,185,204,37740,train,1
8304,img/Zip_Collar_Bomber/img_00000121.jpg,22,50,183,252,Bomber,1,Upper Body,161,202,32522,train,1
8305,img/Zip_Collar_Bomber/img_00000122.jpg,40,62,168,268,Bomber,1,Upper Body,128,206,26368,train,1
8306,img/Zip_Collar_Bomber/img_00000123.jpg,17,66,202,271,Bomber,1,Upper Body,185,205,37925,train,1
8309,img/Zip_Collar_Bomber/img_00000126.jpg,45,78,202,300,Bomber,1,Upper Body,157,222,34854,train,1
8310,img/Zip_Collar_Bomber/img_00000127.jpg,26,54,183,262,Bomber,1,Upper Body,157,208,32656,train,1
8311,img/Zip_Collar_Bomber/img_00000128.jpg,53,66,220,273,Bomber,1,Upper Body,167,207,34569,train,1
8312,img/Zip_Collar_Bomber/img_00000129.jpg,28,66,222,300,Bomber,1,Upper Body,194,234,45396,train,1
8313,img/Zip_Collar_Bomber/img_00000130.jpg,43,57,259,285,Bomber,1,Upper Body,216,228,49248,train,1
8314,img/Zip_Collar_Bomber/img_00000131.jpg,55,68,193,277,Bomber,1,Upper Body,138,209,28842,train,1
8315,img/Zip_Collar_Bomber/img_00000132.jpg,81,67,217,276,Bomber,1,Upper Body,136,209,28424,train,1
8316,img/Zip_Collar_Bomber/img_00000133.jpg,64,53,232,270,Bomber,1,Upper Body,168,217,36456,train,1
8317,img/Zip_Collar_Bomber/img_00000134.jpg,46,56,206,269,Bomber,1,Upper Body,160,213,34080,train,1
8318,img/Zip_Collar_Bomber/img_00000135.jpg,24,57,175,250,Bomber,1,Upper Body,151,193,29143,train,1
8319,img/Zip_Collar_Bomber/img_00000136.jpg,30,47,188,241,Bomber,1,Upper Body,158,194,30652,train,1
8321,img/Zip_Collar_Bomber/img_00000138.jpg,32,35,183,231,Bomber,1,Upper Body,151,196,29596,train,1
8322,img/Zip_Collar_Bomber/img_00000139.jpg,16,1,204,242,Bomber,1,Upper Body,188,241,45308,train,1
8323,img/Zip_Collar_Bomber/img_00000140.jpg,37,60,152,257,Bomber,1,Upper Body,115,197,22655,train,1
8326,img/Zip_Collar_Bomber/img_00000143.jpg,35,65,222,300,Bomber,1,Upper Body,187,235,43945,train,1
8327,img/Zip_Collar_Bomber/img_00000144.jpg,10,19,176,245,Bomber,1,Upper Body,166,226,37516,train,1
8328,img/Zip_Collar_Bomber/img_00000145.jpg,30,10,158,199,Bomber,1,Upper Body,128,189,24192,train,1
22595,img/Hooded_Cotton_Canvas_Anorak/img_00000001.jpg,64,51,218,290,Anorak,1,Upper Body,154,239,36806,train,0
22596,img/Hooded_Cotton_Canvas_Anorak/img_00000002.jpg,84,36,247,300,Anorak,1,Upper Body,163,264,43032,train,0
22597,img/Hooded_Cotton_Canvas_Anorak/img_00000003.jpg,46,60,197,300,Anorak,1,Upper Body,151,240,36240,train,0
22598,img/Hooded_Cotton_Canvas_Anorak/img_00000004.jpg,35,54,193,280,Anorak,1,Upper Body,158,226,35708,train,0
22601,img/Hooded_Cotton_Canvas_Anorak/img_00000007.jpg,56,1,272,300,Anorak,1,Upper Body,216,299,64584,train,0
22603,img/Hooded_Cotton_Canvas_Anorak/img_00000009.jpg,32,41,178,216,Anorak,1,Upper Body,146,175,25550,train,0
22604,img/Hooded_Cotton_Canvas_Anorak/img_00000010.jpg,27,1,176,265,Anorak,1,Upper Body,149,264,39336,train,0
22605,img/Hooded_Cotton_Canvas_Anorak/img_00000011.jpg,48,40,180,223,Anorak,1,Upper Body,132,183,24156,train,0
22606,img/Hooded_Cotton_Canvas_Anorak/img_00000012.jpg,48,47,208,300,Anorak,1,Upper Body,160,253,40480,train,0
22607,img/Hooded_Cotton_Canvas_Anorak/img_00000013.jpg,24,63,185,295,Anorak,1,Upper Body,161,232,37352,train,0
22608,img/Hooded_Cotton_Canvas_Anorak/img_00000014.jpg,34,59,228,300,Anorak,1,Upper Body,194,241,46754,train,0
22610,img/Hooded_Cotton_Canvas_Anorak/img_00000016.jpg,39,3,195,212,Anorak,1,Upper Body,156,209,32604,train,0
22611,img/Hooded_Cotton_Canvas_Anorak/img_00000017.jpg,30,39,172,241,Anorak,1,Upper Body,142,202,28684,train,0
22614,img/Hooded_Cotton_Canvas_Anorak/img_00000020.jpg,73,57,230,247,Anorak,1,Upper Body,157,190,29830,train,0
22616,img/Hooded_Cotton_Canvas_Anorak/img_00000022.jpg,79,52,210,248,Anorak,1,Upper Body,131,196,25676,train,0
22617,img/Hooded_Cotton_Canvas_Anorak/img_00000023.jpg,18,35,186,300,Anorak,1,Upper Body,168,265,44520,train,0
22619,img/Hooded_Cotton_Canvas_Anorak/img_00000025.jpg,68,32,147,200,Anorak,1,Upper Body,79,168,13272,train,0
22621,img/Hooded_Cotton_Canvas_Anorak/img_00000027.jpg,83,43,235,298,Anorak,1,Upper Body,152,255,38760,train,0
22622,img/Hooded_Cotton_Canvas_Anorak/img_00000028.jpg,1,43,226,300,Anorak,1,Upper Body,225,257,57825,train,0
22624,img/Hooded_Cotton_Canvas_Anorak/img_00000030.jpg,57,37,218,292,Anorak,1,Upper Body,161,255,41055,train,0
22625,img/Hooded_Cotton_Canvas_Anorak/img_00000031.jpg,103,27,219,211,Anorak,1,Upper Body,116,184,21344,train,0
22626,img/Hooded_Cotton_Canvas_Anorak/img_00000032.jpg,31,33,175,244,Anorak,1,Upper Body,144,211,30384,train,0
22627,img/Hooded_Cotton_Canvas_Anorak/img_00000033.jpg,30,29,145,150,Anorak,1,Upper Body,115,121,13915,train,0
22628,img/Hooded_Cotton_Canvas_Anorak/img_00000034.jpg,23,31,155,197,Anorak,1,Upper Body,132,166,21912,train,0
22629,img/Hooded_Cotton_Canvas_Anorak/img_00000035.jpg,114,7,184,113,Anorak,1,Upper Body,70,106,7420,train,0
22630,img/Hooded_Cotton_Canvas_Anorak/img_00000036.jpg,27,51,224,282,Anorak,1,Upper Body,197,231,45507,train,0
22633,img/Hooded_Cotton_Canvas_Anorak/img_00000039.jpg,51,58,207,290,Anorak,1,Upper Body,156,232,36192,train,0
22634,img/Hooded_Cotton_Canvas_Anorak/img_00000040.jpg,102,39,167,171,Anorak,1,Upper Body,65,132,8580,train,0
22635,img/Hooded_Cotton_Canvas_Anorak/img_00000041.jpg,54,120,215,251,Anorak,1,Upper Body,161,131,21091,train,0
22636,img/Hooded_Cotton_Canvas_Anorak/img_00000042.jpg,27,40,172,219,Anorak,1,Upper Body,145,179,25955,train,0
22640,img/Hooded_Cotton_Canvas_Anorak/img_00000046.jpg,1,7,136,136,Anorak,1,Upper Body,135,129,17415,train,0
22641,img/Hooded_Cotton_Canvas_Anorak/img_00000047.jpg,32,34,140,184,Anorak,1,Upper Body,108,150,16200,train,0
22643,img/Hooded_Cotton_Canvas_Anorak/img_00000049.jpg,46,21,252,272,Anorak,1,Upper Body,206,251,51706,train,0
22644,img/Hooded_Cotton_Canvas_Anorak/img_00000050.jpg,22,65,180,292,Anorak,1,Upper Body,158,227,35866,train,0
22645,img/Hooded_Cotton_Canvas_Anorak/img_00000051.jpg,29,72,279,300,Anorak,1,Upper Body,250,228,57000,train,0
22646,img/Hooded_Cotton_Canvas_Anorak/img_00000052.jpg,53,29,145,191,Anorak,1,Upper Body,92,162,14904,train,0
22647,img/Hooded_Cotton_Canvas_Anorak/img_00000053.jpg,20,6,106,144,Anorak,1,Upper Body,86,138,11868,train,0
22648,img/Hooded_Cotton_Canvas_Anorak/img_00000054.jpg,25,22,182,272,Anorak,1,Upper Body,157,250,39250,train,0
22650,img/Hooded_Cotton_Canvas_Anorak/img_00000056.jpg,20,49,190,300,Anorak,1,Upper Body,170,251,42670,train,0
22654,img/Hooded_Cotton_Canvas_Anorak/img_00000060.jpg,30,54,215,300,Anorak,1,Upper Body,185,246,45510,train,0
22655,img/Hooded_Cotton_Canvas_Anorak/img_00000061.jpg,1,1,225,266,Anorak,1,Upper Body,224,265,59360,train,0
22657,img/Hooded_Cotton_Canvas_Anorak/img_00000063.jpg,32,55,206,265,Anorak,1,Upper Body,174,210,36540,train,0
22658,img/Hooded_Cotton_Canvas_Anorak/img_00000064.jpg,1,70,212,300,Anorak,1,Upper Body,211,230,48530,train,0
22659,img/Hooded_Cotton_Canvas_Anorak/img_00000065.jpg,1,48,152,300,Anorak,1,Upper Body,151,252,38052,train,0
22660,img/Hooded_Cotton_Canvas_Anorak/img_00000066.jpg,10,3,233,279,Anorak,1,Upper Body,223,276,61548,train,0
22661,img/Hooded_Cotton_Canvas_Anorak/img_00000067.jpg,78,65,133,273,Anorak,1,Upper Body,55,208,11440,train,0
22662,img/Hooded_Cotton_Canvas_Anorak/img_00000068.jpg,38,59,204,293,Anorak,1,Upper Body,166,234,38844,train,0
22663,img/Hooded_Cotton_Canvas_Anorak/img_00000069.jpg,25,66,197,289,Anorak,1,Upper Body,172,223,38356,train,0
22665,img/Hooded_Cotton_Canvas_Anorak/img_00000071.jpg,24,48,149,195,Anorak,1,Upper Body,125,147,18375,train,0
22666,img/Hooded_Cotton_Canvas_Anorak/img_00000072.jpg,1,20,149,224,Anorak,1,Upper Body,148,204,30192,train,0
22667,img/Hooded_Cotton_Canvas_Anorak/img_00000073.jpg,40,1,261,225,Anorak,1,Upper Body,221,224,49504,train,0
22668,img/Hooded_Cotton_Canvas_Anorak/img_00000074.jpg,16,49,168,272,Anorak,1,Upper Body,152,223,33896,train,0
22669,img/Hooded_Cotton_Canvas_Anorak/img_00000075.jpg,28,45,185,300,Anorak,1,Upper Body,157,255,40035,train,0
22670,img/Hooded_Cotton_Canvas_Anorak/img_00000076.jpg,1,3,200,300,Anorak,1,Upper Body,199,297,59103,train,0
22671,img/Hooded_Cotton_Canvas_Anorak/img_00000077.jpg,76,37,246,300,Anorak,1,Upper Body,170,263,44710,train,0
22672,img/Hooded_Cotton_Canvas_Anorak/img_00000078.jpg,3,6,300,300,Anorak,1,Upper Body,297,294,87318,train,0
22673,img/Hooded_Cotton_Canvas_Anorak/img_00000079.jpg,52,8,258,300,Anorak,1,Upper Body,206,292,60152,train,0
22674,img/Hooded_Cotton_Canvas_Anorak/img_00000080.jpg,50,38,187,249,Anorak,1,Upper Body,137,211,28907,train,0
22676,img/Hooded_Cotton_Canvas_Anorak/img_00000082.jpg,35,27,258,300,Anorak,1,Upper Body,223,273,60879,train,0
22677,img/Hooded_Cotton_Canvas_Anorak/img_00000083.jpg,20,13,166,257,Anorak,1,Upper Body,146,244,35624,train,0
22678,img/Hooded_Cotton_Canvas_Anorak/img_00000084.jpg,1,10,300,199,Anorak,1,Upper Body,299,189,56511,train,0
22679,img/Hooded_Cotton_Canvas_Anorak/img_00000085.jpg,52,1,222,279,Anorak,1,Upper Body,170,278,47260,train,0
22680,img/Hooded_Cotton_Canvas_Anorak/img_00000086.jpg,56,1,178,152,Anorak,1,Upper Body,122,151,18422,train,0
22681,img/Hooded_Cotton_Canvas_Anorak/img_00000088.jpg,28,60,200,276,Anorak,1,Upper Body,172,216,37152,train,0
22682,img/Hooded_Cotton_Canvas_Anorak/img_00000089.jpg,53,42,207,233,Anorak,1,Upper Body,154,191,29414,train,0
22683,img/Hooded_Cotton_Canvas_Anorak/img_00000090.jpg,1,7,196,300,Anorak,1,Upper Body,195,293,57135,train,0
22684,img/Hooded_Cotton_Canvas_Anorak/img_00000091.jpg,28,28,278,276,Anorak,1,Upper Body,250,248,62000,train,0
22685,img/Hooded_Cotton_Canvas_Anorak/img_00000092.jpg,36,41,186,260,Anorak,1,Upper Body,150,219,32850,train,0
22686,img/Hooded_Cotton_Canvas_Anorak/img_00000093.jpg,40,1,246,299,Anorak,1,Upper Body,206,298,61388,train,0
22688,img/Hooded_Cotton_Canvas_Anorak/img_00000095.jpg,20,74,193,300,Anorak,1,Upper Body,173,226,39098,train,0
22691,img/Hooded_Cotton_Canvas_Anorak/img_00000098.jpg,53,44,221,300,Anorak,1,Upper Body,168,256,43008,train,0
22692,img/Hooded_Cotton_Canvas_Anorak/img_00000099.jpg,16,27,159,205,Anorak,1,Upper Body,143,178,25454,train,0
22693,img/Hooded_Cotton_Canvas_Anorak/img_00000100.jpg,84,53,218,282,Anorak,1,Upper Body,134,229,30686,train,0
22695,img/Hooded_Cotton_Canvas_Anorak/img_00000102.jpg,42,69,192,262,Anorak,1,Upper Body,150,193,28950,train,0
22696,img/Hooded_Cotton_Canvas_Anorak/img_00000103.jpg,1,36,248,300,Anorak,1,Upper Body,247,264,65208,train,0
22698,img/Hooded_Cotton_Canvas_Anorak/img_00000105.jpg,22,48,172,282,Anorak,1,Upper Body,150,234,35100,train,0
22699,img/Hooded_Cotton_Canvas_Anorak/img_00000106.jpg,63,46,152,167,Anorak,1,Upper Body,89,121,10769,train,0
22700,img/Hooded_Cotton_Canvas_Anorak/img_00000107.jpg,17,44,271,300,Anorak,1,Upper Body,254,256,65024,train,0
22701,img/Hooded_Cotton_Canvas_Anorak/img_00000108.jpg,23,48,183,290,Anorak,1,Upper Body,160,242,38720,train,0
22703,img/Hooded_Cotton_Canvas_Anorak/img_00000110.jpg,69,1,268,266,Anorak,1,Upper Body,199,265,52735,train,0
22704,img/Hooded_Cotton_Canvas_Anorak/img_00000111.jpg,44,32,202,300,Anorak,1,Upper Body,158,268,42344,train,0
22705,img/Hooded_Cotton_Canvas_Anorak/img_00000112.jpg,5,46,198,290,Anorak,1,Upper Body,193,244,47092,train,0
22706,img/Hooded_Cotton_Canvas_Anorak/img_00000113.jpg,61,1,265,231,Anorak,1,Upper Body,204,230,46920,train,0
22707,img/Hooded_Cotton_Canvas_Anorak/img_00000114.jpg,43,50,199,300,Anorak,1,Upper Body,156,250,39000,train,0
22708,img/Hooded_Cotton_Canvas_Anorak/img_00000115.jpg,26,40,192,300,Anorak,1,Upper Body,166,260,43160,train,0
22709,img/Hooded_Cotton_Canvas_Anorak/img_00000116.jpg,43,31,222,300,Anorak,1,Upper Body,179,269,48151,train,0
22710,img/Hooded_Cotton_Canvas_Anorak/img_00000117.jpg,1,8,106,154,Anorak,1,Upper Body,105,146,15330,train,0
22711,img/Hooded_Cotton_Canvas_Anorak/img_00000118.jpg,40,39,214,298,Anorak,1,Upper Body,174,259,45066,train,0
22713,img/Hooded_Cotton_Canvas_Anorak/img_00000120.jpg,23,50,179,294,Anorak,1,Upper Body,156,244,38064,train,0
22714,img/Hooded_Cotton_Canvas_Anorak/img_00000121.jpg,29,36,173,278,Anorak,1,Upper Body,144,242,34848,train,0
22715,img/Hooded_Cotton_Canvas_Anorak/img_00000122.jpg,39,63,209,278,Anorak,1,Upper Body,170,215,36550,train,0
22718,img/Hooded_Cotton_Canvas_Anorak/img_00000125.jpg,36,35,190,277,Anorak,1,Upper Body,154,242,37268,train,0
22719,img/Hooded_Cotton_Canvas_Anorak/img_00000126.jpg,1,55,249,300,Anorak,1,Upper Body,248,245,60760,train,0
22720,img/Hooded_Cotton_Canvas_Anorak/img_00000127.jpg,66,34,167,163,Anorak,1,Upper Body,101,129,13029,train,0
22721,img/Hooded_Cotton_Canvas_Anorak/img_00000128.jpg,28,46,188,276,Anorak,1,Upper Body,160,230,36800,train,0
22722,img/Hooded_Cotton_Canvas_Anorak/img_00000129.jpg,12,1,269,285,Anorak,1,Upper Body,257,284,72988,train,0
22723,img/Hooded_Cotton_Canvas_Anorak/img_00000130.jpg,60,44,212,250,Anorak,1,Upper Body,152,206,31312,train,0
22724,img/Hooded_Cotton_Canvas_Anorak/img_00000131.jpg,92,2,202,126,Anorak,1,Upper Body,110,124,13640,train,0
22726,img/Hooded_Cotton_Canvas_Anorak/img_00000133.jpg,138,107,300,296,Anorak,1,Upper Body,162,189,30618,train,0
22727,img/Hooded_Cotton_Canvas_Anorak/img_00000134.jpg,70,53,273,283,Anorak,1,Upper Body,203,230,46690,train,0
22728,img/Hooded_Cotton_Canvas_Anorak/img_00000135.jpg,48,38,154,161,Anorak,1,Upper Body,106,123,13038,train,0
22729,img/Hooded_Cotton_Canvas_Anorak/img_00000136.jpg,57,51,223,300,Anorak,1,Upper Body,166,249,41334,train,0
22731,img/Hooded_Cotton_Canvas_Anorak/img_00000138.jpg,13,53,196,299,Anorak,1,Upper Body,183,246,45018,train,0
22733,img/Hooded_Cotton_Canvas_Anorak/img_00000140.jpg,1,1,201,285,Anorak,1,Upper Body,200,284,56800,train,0
22734,img/Hooded_Cotton_Canvas_Anorak/img_00000141.jpg,29,38,283,300,Anorak,1,Upper Body,254,262,66548,train,0
22735,img/Hooded_Cotton_Canvas_Anorak/img_00000142.jpg,41,47,209,299,Anorak,1,Upper Body,168,252,42336,train,0
22736,img/Hooded_Cotton_Canvas_Anorak/img_00000143.jpg,29,44,279,300,Anorak,1,Upper Body,250,256,64000,train,0
22740,img/Hooded_Cotton_Canvas_Anorak/img_00000147.jpg,60,49,221,300,Anorak,1,Upper Body,161,251,40411,train,0
22741,img/Hooded_Cotton_Canvas_Anorak/img_00000148.jpg,56,46,250,300,Anorak,1,Upper Body,194,254,49276,train,0
22742,img/Hooded_Cotton_Canvas_Anorak/img_00000149.jpg,62,47,163,279,Anorak,1,Upper Body,101,232,23432,train,0
22743,img/Hooded_Cotton_Canvas_Anorak/img_00000150.jpg,26,51,198,293,Anorak,1,Upper Body,172,242,41624,train,0
22744,img/Hooded_Cotton_Canvas_Anorak/img_00000151.jpg,33,42,164,287,Anorak,1,Upper Body,131,245,32095,train,0
22745,img/Hooded_Cotton_Canvas_Anorak/img_00000152.jpg,25,46,168,297,Anorak,1,Upper Body,143,251,35893,train,0
22746,img/Hooded_Cotton_Canvas_Anorak/img_00000153.jpg,15,48,194,300,Anorak,1,Upper Body,179,252,45108,train,0
22747,img/Hooded_Cotton_Canvas_Anorak/img_00000154.jpg,22,1,190,289,Anorak,1,Upper Body,168,288,48384,train,0
22748,img/Hooded_Cotton_Canvas_Anorak/img_00000155.jpg,1,1,180,269,Anorak,1,Upper Body,179,268,47972,train,0
22749,img/Hooded_Cotton_Canvas_Anorak/img_00000156.jpg,56,51,192,240,Anorak,1,Upper Body,136,189,25704,train,0
22750,img/Hooded_Cotton_Canvas_Anorak/img_00000157.jpg,46,28,126,134,Anorak,1,Upper Body,80,106,8480,train,0
22751,img/Hooded_Cotton_Canvas_Anorak/img_00000158.jpg,17,46,187,296,Anorak,1,Upper Body,170,250,42500,train,0
22753,img/Hooded_Cotton_Canvas_Anorak/img_00000160.jpg,37,9,198,277,Anorak,1,Upper Body,161,268,43148,train,0
22754,img/Hooded_Cotton_Canvas_Anorak/img_00000161.jpg,16,5,288,300,Anorak,1,Upper Body,272,295,80240,train,0
29772,img/Quilted_Faux_Leather_Bomber/img_00000002.jpg,113,80,237,260,Bomber,1,Upper Body,124,180,22320,train,1
29774,img/Quilted_Faux_Leather_Bomber/img_00000004.jpg,41,84,229,288,Bomber,1,Upper Body,188,204,38352,train,1
29777,img/Quilted_Faux_Leather_Bomber/img_00000007.jpg,12,51,180,245,Bomber,1,Upper Body,168,194,32592,train,1
29778,img/Quilted_Faux_Leather_Bomber/img_00000008.jpg,41,43,179,221,Bomber,1,Upper Body,138,178,24564,train,1
29779,img/Quilted_Faux_Leather_Bomber/img_00000009.jpg,56,42,141,134,Bomber,1,Upper Body,85,92,7820,train,1
29780,img/Quilted_Faux_Leather_Bomber/img_00000010.jpg,3,44,124,180,Bomber,1,Upper Body,121,136,16456,train,1
29781,img/Quilted_Faux_Leather_Bomber/img_00000011.jpg,10,61,195,260,Bomber,1,Upper Body,185,199,36815,train,1
29782,img/Quilted_Faux_Leather_Bomber/img_00000012.jpg,138,33,300,177,Bomber,1,Upper Body,162,144,23328,train,1
29783,img/Quilted_Faux_Leather_Bomber/img_00000013.jpg,167,58,294,226,Bomber,1,Upper Body,127,168,21336,train,1
29784,img/Quilted_Faux_Leather_Bomber/img_00000014.jpg,56,47,126,130,Bomber,1,Upper Body,70,83,5810,train,1
29786,img/Quilted_Faux_Leather_Bomber/img_00000016.jpg,41,58,69,243,Bomber,1,Upper Body,28,185,5180,train,1
29787,img/Quilted_Faux_Leather_Bomber/img_00000017.jpg,47,101,172,255,Bomber,1,Upper Body,125,154,19250,train,1
29788,img/Quilted_Faux_Leather_Bomber/img_00000018.jpg,30,68,187,212,Bomber,1,Upper Body,157,144,22608,train,1
29789,img/Quilted_Faux_Leather_Bomber/img_00000019.jpg,11,95,245,300,Bomber,1,Upper Body,234,205,47970,train,1
29790,img/Quilted_Faux_Leather_Bomber/img_00000020.jpg,16,54,147,216,Bomber,1,Upper Body,131,162,21222,train,1
29791,img/Quilted_Faux_Leather_Bomber/img_00000021.jpg,102,42,173,156,Bomber,1,Upper Body,71,114,8094,train,1
29793,img/Quilted_Faux_Leather_Bomber/img_00000023.jpg,12,77,193,271,Bomber,1,Upper Body,181,194,35114,train,1
29794,img/Quilted_Faux_Leather_Bomber/img_00000024.jpg,64,76,231,254,Bomber,1,Upper Body,167,178,29726,train,1
29798,img/Quilted_Faux_Leather_Bomber/img_00000028.jpg,57,67,191,300,Bomber,1,Upper Body,134,233,31222,train,1
29799,img/Quilted_Faux_Leather_Bomber/img_00000029.jpg,166,70,300,253,Bomber,1,Upper Body,134,183,24522,train,1
29800,img/Quilted_Faux_Leather_Bomber/img_00000030.jpg,31,70,216,264,Bomber,1,Upper Body,185,194,35890,train,1
29801,img/Quilted_Faux_Leather_Bomber/img_00000031.jpg,77,81,199,235,Bomber,1,Upper Body,122,154,18788,train,1
29802,img/Quilted_Faux_Leather_Bomber/img_00000032.jpg,54,79,212,280,Bomber,1,Upper Body,158,201,31758,train,1
29803,img/Quilted_Faux_Leather_Bomber/img_00000033.jpg,81,70,190,176,Bomber,1,Upper Body,109,106,11554,train,1
29804,img/Quilted_Faux_Leather_Bomber/img_00000034.jpg,36,81,235,300,Bomber,1,Upper Body,199,219,43581,train,1
29805,img/Quilted_Faux_Leather_Bomber/img_00000035.jpg,39,37,121,136,Bomber,1,Upper Body,82,99,8118,train,1
29806,img/Quilted_Faux_Leather_Bomber/img_00000036.jpg,18,70,203,283,Bomber,1,Upper Body,185,213,39405,train,1
29807,img/Quilted_Faux_Leather_Bomber/img_00000037.jpg,18,71,190,255,Bomber,1,Upper Body,172,184,31648,train,1
29809,img/Quilted_Faux_Leather_Bomber/img_00000039.jpg,82,66,202,300,Bomber,1,Upper Body,120,234,28080,train,1
29810,img/Quilted_Faux_Leather_Bomber/img_00000040.jpg,69,78,236,233,Bomber,1,Upper Body,167,155,25885,train,1
29811,img/Quilted_Faux_Leather_Bomber/img_00000041.jpg,1,58,200,284,Bomber,1,Upper Body,199,226,44974,train,1
29813,img/Quilted_Faux_Leather_Bomber/img_00000043.jpg,85,71,230,237,Bomber,1,Upper Body,145,166,24070,train,1
29814,img/Quilted_Faux_Leather_Bomber/img_00000044.jpg,74,44,180,157,Bomber,1,Upper Body,106,113,11978,train,1
29815,img/Quilted_Faux_Leather_Bomber/img_00000045.jpg,70,75,206,252,Bomber,1,Upper Body,136,177,24072,train,1
29817,img/Quilted_Faux_Leather_Bomber/img_00000047.jpg,78,92,234,300,Bomber,1,Upper Body,156,208,32448,train,1
29818,img/Quilted_Faux_Leather_Bomber/img_00000048.jpg,1,92,201,288,Bomber,1,Upper Body,200,196,39200,train,1
29820,img/Quilted_Faux_Leather_Bomber/img_00000050.jpg,89,77,235,300,Bomber,1,Upper Body,146,223,32558,train,1
29821,img/Quilted_Faux_Leather_Bomber/img_00000051.jpg,40,83,198,293,Bomber,1,Upper Body,158,210,33180,train,1
29822,img/Quilted_Faux_Leather_Bomber/img_00000052.jpg,72,50,149,145,Bomber,1,Upper Body,77,95,7315,train,1
29823,img/Quilted_Faux_Leather_Bomber/img_00000053.jpg,87,37,214,285,Bomber,1,Upper Body,127,248,31496,train,1
29824,img/Quilted_Faux_Leather_Bomber/img_00000054.jpg,19,72,219,293,Bomber,1,Upper Body,200,221,44200,train,1
29825,img/Quilted_Faux_Leather_Bomber/img_00000055.jpg,14,69,236,300,Bomber,1,Upper Body,222,231,51282,train,1
29827,img/Quilted_Faux_Leather_Bomber/img_00000057.jpg,28,65,152,173,Bomber,1,Upper Body,124,108,13392,train,1
29828,img/Quilted_Faux_Leather_Bomber/img_00000058.jpg,31,57,182,246,Bomber,1,Upper Body,151,189,28539,train,1
29829,img/Quilted_Faux_Leather_Bomber/img_00000059.jpg,23,56,195,249,Bomber,1,Upper Body,172,193,33196,train,1
29832,img/Quilted_Faux_Leather_Bomber/img_00000062.jpg,56,58,134,154,Bomber,1,Upper Body,78,96,7488,train,1
29833,img/Quilted_Faux_Leather_Bomber/img_00000063.jpg,38,72,224,265,Bomber,1,Upper Body,186,193,35898,train,1
29834,img/Quilted_Faux_Leather_Bomber/img_00000064.jpg,102,57,218,180,Bomber,1,Upper Body,116,123,14268,train,1
29835,img/Quilted_Faux_Leather_Bomber/img_00000065.jpg,15,125,215,299,Bomber,1,Upper Body,200,174,34800,train,1
29838,img/Quilted_Faux_Leather_Bomber/img_00000068.jpg,56,57,187,246,Bomber,1,Upper Body,131,189,24759,train,1
29839,img/Quilted_Faux_Leather_Bomber/img_00000069.jpg,14,73,195,240,Bomber,1,Upper Body,181,167,30227,train,1
29840,img/Quilted_Faux_Leather_Bomber/img_00000070.jpg,63,80,130,167,Bomber,1,Upper Body,67,87,5829,train,1
29841,img/Quilted_Faux_Leather_Bomber/img_00000071.jpg,22,81,219,299,Bomber,1,Upper Body,197,218,42946,train,1
29842,img/Quilted_Faux_Leather_Bomber/img_00000072.jpg,9,64,215,260,Bomber,1,Upper Body,206,196,40376,train,1
29845,img/Quilted_Faux_Leather_Bomber/img_00000075.jpg,68,42,164,155,Bomber,1,Upper Body,96,113,10848,train,1
29846,img/Quilted_Faux_Leather_Bomber/img_00000076.jpg,76,67,239,266,Bomber,1,Upper Body,163,199,32437,train,1
29847,img/Quilted_Faux_Leather_Bomber/img_00000077.jpg,31,69,198,215,Bomber,1,Upper Body,167,146,24382,train,1
29849,img/Quilted_Faux_Leather_Bomber/img_00000079.jpg,39,60,148,205,Bomber,1,Upper Body,109,145,15805,train,1
29850,img/Quilted_Faux_Leather_Bomber/img_00000080.jpg,21,66,170,235,Bomber,1,Upper Body,149,169,25181,train,1
29851,img/Quilted_Faux_Leather_Bomber/img_00000081.jpg,56,80,250,210,Bomber,1,Upper Body,194,130,25220,train,1
29852,img/Quilted_Faux_Leather_Bomber/img_00000082.jpg,1,28,225,293,Bomber,1,Upper Body,224,265,59360,train,1
29853,img/Quilted_Faux_Leather_Bomber/img_00000083.jpg,22,44,296,300,Bomber,1,Upper Body,274,256,70144,train,1
29854,img/Quilted_Faux_Leather_Bomber/img_00000084.jpg,54,66,181,276,Bomber,1,Upper Body,127,210,26670,train,1
29856,img/Quilted_Faux_Leather_Bomber/img_00000086.jpg,13,78,205,299,Bomber,1,Upper Body,192,221,42432,train,1
29857,img/Quilted_Faux_Leather_Bomber/img_00000087.jpg,82,82,219,257,Bomber,1,Upper Body,137,175,23975,train,1
29858,img/Quilted_Faux_Leather_Bomber/img_00000088.jpg,210,54,258,181,Bomber,1,Upper Body,48,127,6096,train,1
29859,img/Quilted_Faux_Leather_Bomber/img_00000089.jpg,56,72,177,225,Bomber,1,Upper Body,121,153,18513,train,1
29860,img/Quilted_Faux_Leather_Bomber/img_00000090.jpg,67,62,230,271,Bomber,1,Upper Body,163,209,34067,train,1
29863,img/Quilted_Faux_Leather_Bomber/img_00000093.jpg,67,74,235,252,Bomber,1,Upper Body,168,178,29904,train,1
29865,img/Quilted_Faux_Leather_Bomber/img_00000095.jpg,38,70,208,260,Bomber,1,Upper Body,170,190,32300,train,1
29866,img/Quilted_Faux_Leather_Bomber/img_00000096.jpg,1,94,222,254,Bomber,1,Upper Body,221,160,35360,train,1
29867,img/Quilted_Faux_Leather_Bomber/img_00000097.jpg,62,70,256,257,Bomber,1,Upper Body,194,187,36278,train,1
29868,img/Quilted_Faux_Leather_Bomber/img_00000098.jpg,18,53,240,300,Bomber,1,Upper Body,222,247,54834,train,1
29870,img/Quilted_Faux_Leather_Bomber/img_00000100.jpg,12,36,190,249,Bomber,1,Upper Body,178,213,37914,train,1
29871,img/Quilted_Faux_Leather_Bomber/img_00000101.jpg,46,89,232,272,Bomber,1,Upper Body,186,183,34038,train,1
29872,img/Quilted_Faux_Leather_Bomber/img_00000102.jpg,20,85,171,258,Bomber,1,Upper Body,151,173,26123,train,1
29873,img/Quilted_Faux_Leather_Bomber/img_00000103.jpg,14,51,96,153,Bomber,1,Upper Body,82,102,8364,train,1
29874,img/Quilted_Faux_Leather_Bomber/img_00000104.jpg,63,58,140,136,Bomber,1,Upper Body,77,78,6006,train,1
29876,img/Quilted_Faux_Leather_Bomber/img_00000106.jpg,26,82,150,225,Bomber,1,Upper Body,124,143,17732,train,1
29877,img/Quilted_Faux_Leather_Bomber/img_00000107.jpg,29,79,147,270,Bomber,1,Upper Body,118,191,22538,train,1
29878,img/Quilted_Faux_Leather_Bomber/img_00000108.jpg,45,51,152,129,Bomber,1,Upper Body,107,78,8346,train,1
29880,img/Quilted_Faux_Leather_Bomber/img_00000110.jpg,2,75,188,247,Bomber,1,Upper Body,186,172,31992,train,1
29882,img/Quilted_Faux_Leather_Bomber/img_00000112.jpg,27,88,243,296,Bomber,1,Upper Body,216,208,44928,train,1
29883,img/Quilted_Faux_Leather_Bomber/img_00000113.jpg,16,77,190,255,Bomber,1,Upper Body,174,178,30972,train,1
29884,img/Quilted_Faux_Leather_Bomber/img_00000114.jpg,63,38,169,148,Bomber,1,Upper Body,106,110,11660,train,1
29885,img/Quilted_Faux_Leather_Bomber/img_00000115.jpg,55,70,212,300,Bomber,1,Upper Body,157,230,36110,train,1
29887,img/Quilted_Faux_Leather_Bomber/img_00000117.jpg,20,30,200,258,Bomber,1,Upper Body,180,228,41040,train,1
29889,img/Quilted_Faux_Leather_Bomber/img_00000119.jpg,65,66,225,244,Bomber,1,Upper Body,160,178,28480,train,1
29892,img/Quilted_Faux_Leather_Bomber/img_00000122.jpg,41,86,163,247,Bomber,1,Upper Body,122,161,19642,train,1
29893,img/Quilted_Faux_Leather_Bomber/img_00000123.jpg,18,78,167,258,Bomber,1,Upper Body,149,180,26820,train,1
29895,img/Quilted_Faux_Leather_Bomber/img_00000125.jpg,9,74,194,265,Bomber,1,Upper Body,185,191,35335,train,1
29898,img/Quilted_Faux_Leather_Bomber/img_00000128.jpg,44,108,246,298,Bomber,1,Upper Body,202,190,38380,train,1
29899,img/Quilted_Faux_Leather_Bomber/img_00000129.jpg,22,63,195,252,Bomber,1,Upper Body,173,189,32697,train,1
29900,img/Quilted_Faux_Leather_Bomber/img_00000130.jpg,26,62,172,253,Bomber,1,Upper Body,146,191,27886,train,1
29903,img/Quilted_Faux_Leather_Bomber/img_00000133.jpg,32,53,171,218,Bomber,1,Upper Body,139,165,22935,train,1
29904,img/Quilted_Faux_Leather_Bomber/img_00000134.jpg,27,20,240,265,Bomber,1,Upper Body,213,245,52185,train,1
29905,img/Quilted_Faux_Leather_Bomber/img_00000135.jpg,15,64,185,243,Bomber,1,Upper Body,170,179,30430,train,1
29907,img/Quilted_Faux_Leather_Bomber/img_00000137.jpg,24,68,242,275,Bomber,1,Upper Body,218,207,45126,train,1
29908,img/Quilted_Faux_Leather_Bomber/img_00000138.jpg,35,69,179,278,Bomber,1,Upper Body,144,209,30096,train,1
29909,img/Quilted_Faux_Leather_Bomber/img_00000139.jpg,23,141,108,279,Bomber,1,Upper Body,85,138,11730,train,1
29910,img/Quilted_Faux_Leather_Bomber/img_00000140.jpg,1,103,229,288,Bomber,1,Upper Body,228,185,42180,train,1
29912,img/Quilted_Faux_Leather_Bomber/img_00000142.jpg,45,73,159,220,Bomber,1,Upper Body,114,147,16758,train,1
29913,img/Quilted_Faux_Leather_Bomber/img_00000143.jpg,82,60,198,216,Bomber,1,Upper Body,116,156,18096,train,1
29914,img/Quilted_Faux_Leather_Bomber/img_00000144.jpg,28,59,189,298,Bomber,1,Upper Body,161,239,38479,train,1
29915,img/Quilted_Faux_Leather_Bomber/img_00000145.jpg,72,69,235,265,Bomber,1,Upper Body,163,196,31948,train,1
29916,img/Quilted_Faux_Leather_Bomber/img_00000146.jpg,70,69,230,265,Bomber,1,Upper Body,160,196,31360,train,1
29917,img/Quilted_Faux_Leather_Bomber/img_00000147.jpg,1,92,300,300,Bomber,1,Upper Body,299,208,62192,train,1
29920,img/Quilted_Faux_Leather_Bomber/img_00000150.jpg,57,89,158,219,Bomber,1,Upper Body,101,130,13130,train,1
29922,img/Quilted_Faux_Leather_Bomber/img_00000152.jpg,1,72,175,241,Bomber,1,Upper Body,174,169,29406,train,1
29923,img/Quilted_Faux_Leather_Bomber/img_00000153.jpg,1,73,195,262,Bomber,1,Upper Body,194,189,36666,train,1
29924,img/Quilted_Faux_Leather_Bomber/img_00000154.jpg,4,81,199,198,Bomber,1,Upper Body,195,117,22815,train,1
29925,img/Quilted_Faux_Leather_Bomber/img_00000155.jpg,72,79,242,254,Bomber,1,Upper Body,170,175,29750,train,1
29926,img/Quilted_Faux_Leather_Bomber/img_00000156.jpg,27,53,186,285,Bomber,1,Upper Body,159,232,36888,train,1
29928,img/Quilted_Faux_Leather_Bomber/img_00000158.jpg,75,74,235,231,Bomber,1,Upper Body,160,157,25120,train,1
29929,img/Quilted_Faux_Leather_Bomber/img_00000159.jpg,49,119,156,269,Bomber,1,Upper Body,107,150,16050,train,1
29930,img/Quilted_Faux_Leather_Bomber/img_00000160.jpg,2,90,189,287,Bomber,1,Upper Body,187,197,36839,train,1
29931,img/Quilted_Faux_Leather_Bomber/img_00000161.jpg,17,77,198,242,Bomber,1,Upper Body,181,165,29865,train,1
29932,img/Quilted_Faux_Leather_Bomber/img_00000162.jpg,64,46,166,153,Bomber,1,Upper Body,102,107,10914,train,1
29933,img/Quilted_Faux_Leather_Bomber/img_00000163.jpg,34,68,154,228,Bomber,1,Upper Body,120,160,19200,train,1
68408,img/Classic_Knit_Turtleneck/img_00000001.jpg,49,70,169,300,Turtleneck,1,Upper Body,120,230,27600,train,10
68410,img/Classic_Knit_Turtleneck/img_00000003.jpg,19,1,173,172,Turtleneck,1,Upper Body,154,171,26334,train,10
68413,img/Classic_Knit_Turtleneck/img_00000006.jpg,1,33,214,170,Turtleneck,1,Upper Body,213,137,29181,train,10
68415,img/Classic_Knit_Turtleneck/img_00000008.jpg,1,1,300,242,Turtleneck,1,Upper Body,299,241,72059,train,10
68416,img/Classic_Knit_Turtleneck/img_00000009.jpg,44,100,218,293,Turtleneck,1,Upper Body,174,193,33582,train,10
68417,img/Classic_Knit_Turtleneck/img_00000010.jpg,66,58,236,267,Turtleneck,1,Upper Body,170,209,35530,train,10
68418,img/Classic_Knit_Turtleneck/img_00000011.jpg,20,71,177,288,Turtleneck,1,Upper Body,157,217,34069,train,10
68419,img/Classic_Knit_Turtleneck/img_00000012.jpg,82,9,204,271,Turtleneck,1,Upper Body,122,262,31964,train,10
68420,img/Classic_Knit_Turtleneck/img_00000013.jpg,74,72,175,298,Turtleneck,1,Upper Body,101,226,22826,train,10
68423,img/Classic_Knit_Turtleneck/img_00000016.jpg,1,56,182,249,Turtleneck,1,Upper Body,181,193,34933,train,10
68424,img/Classic_Knit_Turtleneck/img_00000017.jpg,39,135,226,262,Turtleneck,1,Upper Body,187,127,23749,train,10
68425,img/Classic_Knit_Turtleneck/img_00000018.jpg,76,60,225,280,Turtleneck,1,Upper Body,149,220,32780,train,10
68426,img/Classic_Knit_Turtleneck/img_00000019.jpg,43,53,177,209,Turtleneck,1,Upper Body,134,156,20904,train,10
68427,img/Classic_Knit_Turtleneck/img_00000020.jpg,53,57,226,190,Turtleneck,1,Upper Body,173,133,23009,train,10
68429,img/Classic_Knit_Turtleneck/img_00000022.jpg,30,51,190,273,Turtleneck,1,Upper Body,160,222,35520,train,10
68431,img/Classic_Knit_Turtleneck/img_00000024.jpg,60,39,131,170,Turtleneck,1,Upper Body,71,131,9301,train,10
68435,img/Classic_Knit_Turtleneck/img_00000028.jpg,29,1,179,174,Turtleneck,1,Upper Body,150,173,25950,train,10
68436,img/Classic_Knit_Turtleneck/img_00000029.jpg,3,69,218,246,Turtleneck,1,Upper Body,215,177,38055,train,10
68437,img/Classic_Knit_Turtleneck/img_00000030.jpg,46,36,154,208,Turtleneck,1,Upper Body,108,172,18576,train,10
68441,img/Classic_Knit_Turtleneck/img_00000034.jpg,40,8,78,60,Turtleneck,1,Upper Body,38,52,1976,train,10
68442,img/Classic_Knit_Turtleneck/img_00000035.jpg,42,37,127,172,Turtleneck,1,Upper Body,85,135,11475,train,10
68443,img/Classic_Knit_Turtleneck/img_00000036.jpg,20,13,207,261,Turtleneck,1,Upper Body,187,248,46376,train,10
68444,img/Classic_Knit_Turtleneck/img_00000037.jpg,13,1,206,300,Turtleneck,1,Upper Body,193,299,57707,train,10
68446,img/Classic_Knit_Turtleneck/img_00000039.jpg,30,134,256,269,Turtleneck,1,Upper Body,226,135,30510,train,10
68447,img/Classic_Knit_Turtleneck/img_00000040.jpg,39,48,211,281,Turtleneck,1,Upper Body,172,233,40076,train,10
68448,img/Classic_Knit_Turtleneck/img_00000041.jpg,46,60,159,283,Turtleneck,1,Upper Body,113,223,25199,train,10
68449,img/Classic_Knit_Turtleneck/img_00000042.jpg,54,47,235,285,Turtleneck,1,Upper Body,181,238,43078,train,10
68450,img/Classic_Knit_Turtleneck/img_00000043.jpg,55,47,122,157,Turtleneck,1,Upper Body,67,110,7370,train,10
68451,img/Classic_Knit_Turtleneck/img_00000044.jpg,19,54,177,274,Turtleneck,1,Upper Body,158,220,34760,train,10
68453,img/Classic_Knit_Turtleneck/img_00000046.jpg,42,53,214,276,Turtleneck,1,Upper Body,172,223,38356,train,10
68456,img/Classic_Knit_Turtleneck/img_00000049.jpg,30,65,167,215,Turtleneck,1,Upper Body,137,150,20550,train,10
68457,img/Classic_Knit_Turtleneck/img_00000050.jpg,52,73,198,283,Turtleneck,1,Upper Body,146,210,30660,train,10
68460,img/Classic_Knit_Turtleneck/img_00000053.jpg,33,34,167,208,Turtleneck,1,Upper Body,134,174,23316,train,10
68461,img/Classic_Knit_Turtleneck/img_00000054.jpg,132,21,300,264,Turtleneck,1,Upper Body,168,243,40824,train,10
68462,img/Classic_Knit_Turtleneck/img_00000055.jpg,38,51,234,283,Turtleneck,1,Upper Body,196,232,45472,train,10
68463,img/Classic_Knit_Turtleneck/img_00000056.jpg,84,50,271,300,Turtleneck,1,Upper Body,187,250,46750,train,10
68464,img/Classic_Knit_Turtleneck/img_00000057.jpg,8,1,200,296,Turtleneck,1,Upper Body,192,295,56640,train,10
68465,img/Classic_Knit_Turtleneck/img_00000058.jpg,33,8,261,258,Turtleneck,1,Upper Body,228,250,57000,train,10
77569,img/Cropped_Ribbed_Knit_Turtleneck/img_00000001.jpg,59,56,148,190,Turtleneck,1,Upper Body,89,134,11926,train,10
77570,img/Cropped_Ribbed_Knit_Turtleneck/img_00000002.jpg,82,61,183,172,Turtleneck,1,Upper Body,101,111,11211,train,10
77571,img/Cropped_Ribbed_Knit_Turtleneck/img_00000003.jpg,56,45,164,192,Turtleneck,1,Upper Body,108,147,15876,train,10
77572,img/Cropped_Ribbed_Knit_Turtleneck/img_00000004.jpg,9,77,145,288,Turtleneck,1,Upper Body,136,211,28696,train,10
77573,img/Cropped_Ribbed_Knit_Turtleneck/img_00000005.jpg,65,57,150,236,Turtleneck,1,Upper Body,85,179,15215,train,10
77574,img/Cropped_Ribbed_Knit_Turtleneck/img_00000006.jpg,61,77,200,273,Turtleneck,1,Upper Body,139,196,27244,train,10
77576,img/Cropped_Ribbed_Knit_Turtleneck/img_00000008.jpg,79,61,225,258,Turtleneck,1,Upper Body,146,197,28762,train,10
77577,img/Cropped_Ribbed_Knit_Turtleneck/img_00000009.jpg,99,74,181,257,Turtleneck,1,Upper Body,82,183,15006,train,10
77579,img/Cropped_Ribbed_Knit_Turtleneck/img_00000011.jpg,70,87,135,185,Turtleneck,1,Upper Body,65,98,6370,train,10
77582,img/Cropped_Ribbed_Knit_Turtleneck/img_00000014.jpg,100,49,245,242,Turtleneck,1,Upper Body,145,193,27985,train,10
77583,img/Cropped_Ribbed_Knit_Turtleneck/img_00000015.jpg,59,67,155,189,Turtleneck,1,Upper Body,96,122,11712,train,10
77584,img/Cropped_Ribbed_Knit_Turtleneck/img_00000016.jpg,62,41,142,127,Turtleneck,1,Upper Body,80,86,6880,train,10
77586,img/Cropped_Ribbed_Knit_Turtleneck/img_00000018.jpg,22,49,120,162,Turtleneck,1,Upper Body,98,113,11074,train,10
77588,img/Cropped_Ribbed_Knit_Turtleneck/img_00000020.jpg,1,34,130,280,Turtleneck,1,Upper Body,129,246,31734,train,10
77590,img/Cropped_Ribbed_Knit_Turtleneck/img_00000022.jpg,77,37,136,181,Turtleneck,1,Upper Body,59,144,8496,train,10
77591,img/Cropped_Ribbed_Knit_Turtleneck/img_00000023.jpg,39,73,153,180,Turtleneck,1,Upper Body,114,107,12198,train,10
77592,img/Cropped_Ribbed_Knit_Turtleneck/img_00000024.jpg,58,54,194,272,Turtleneck,1,Upper Body,136,218,29648,train,10
77593,img/Cropped_Ribbed_Knit_Turtleneck/img_00000025.jpg,55,96,133,230,Turtleneck,1,Upper Body,78,134,10452,train,10
77594,img/Cropped_Ribbed_Knit_Turtleneck/img_00000026.jpg,30,40,86,161,Turtleneck,1,Upper Body,56,121,6776,train,10
77595,img/Cropped_Ribbed_Knit_Turtleneck/img_00000027.jpg,27,102,170,256,Turtleneck,1,Upper Body,143,154,22022,train,10
77596,img/Cropped_Ribbed_Knit_Turtleneck/img_00000028.jpg,8,51,188,300,Turtleneck,1,Upper Body,180,249,44820,train,10
77600,img/Cropped_Ribbed_Knit_Turtleneck/img_00000032.jpg,37,47,159,238,Turtleneck,1,Upper Body,122,191,23302,train,10
77601,img/Cropped_Ribbed_Knit_Turtleneck/img_00000033.jpg,88,73,153,191,Turtleneck,1,Upper Body,65,118,7670,train,10
77602,img/Cropped_Ribbed_Knit_Turtleneck/img_00000034.jpg,67,35,108,131,Turtleneck,1,Upper Body,41,96,3936,train,10
77603,img/Cropped_Ribbed_Knit_Turtleneck/img_00000035.jpg,19,63,180,268,Turtleneck,1,Upper Body,161,205,33005,train,10
77604,img/Cropped_Ribbed_Knit_Turtleneck/img_00000036.jpg,1,77,225,300,Turtleneck,1,Upper Body,224,223,49952,train,10
77605,img/Cropped_Ribbed_Knit_Turtleneck/img_00000037.jpg,83,56,239,266,Turtleneck,1,Upper Body,156,210,32760,train,10
77606,img/Cropped_Ribbed_Knit_Turtleneck/img_00000038.jpg,47,55,192,251,Turtleneck,1,Upper Body,145,196,28420,train,10
77607,img/Cropped_Ribbed_Knit_Turtleneck/img_00000039.jpg,72,60,164,250,Turtleneck,1,Upper Body,92,190,17480,train,10
77608,img/Cropped_Ribbed_Knit_Turtleneck/img_00000040.jpg,82,47,212,263,Turtleneck,1,Upper Body,130,216,28080,train,10
77611,img/Cropped_Ribbed_Knit_Turtleneck/img_00000043.jpg,90,37,160,171,Turtleneck,1,Upper Body,70,134,9380,train,10
77613,img/Cropped_Ribbed_Knit_Turtleneck/img_00000045.jpg,30,40,151,299,Turtleneck,1,Upper Body,121,259,31339,train,10
77614,img/Cropped_Ribbed_Knit_Turtleneck/img_00000046.jpg,56,45,112,140,Turtleneck,1,Upper Body,56,95,5320,train,10
77615,img/Cropped_Ribbed_Knit_Turtleneck/img_00000047.jpg,123,62,211,193,Turtleneck,1,Upper Body,88,131,11528,train,10
77616,img/Cropped_Ribbed_Knit_Turtleneck/img_00000048.jpg,59,40,138,141,Turtleneck,1,Upper Body,79,101,7979,train,10
77617,img/Cropped_Ribbed_Knit_Turtleneck/img_00000049.jpg,118,71,226,261,Turtleneck,1,Upper Body,108,190,20520,train,10
77618,img/Cropped_Ribbed_Knit_Turtleneck/img_00000050.jpg,60,35,220,264,Turtleneck,1,Upper Body,160,229,36640,train,10
77620,img/Cropped_Ribbed_Knit_Turtleneck/img_00000052.jpg,71,51,237,286,Turtleneck,1,Upper Body,166,235,39010,train,10
77621,img/Cropped_Ribbed_Knit_Turtleneck/img_00000053.jpg,110,91,216,197,Turtleneck,1,Upper Body,106,106,11236,train,10
82854,img/Double-Breasted_Peacoat/img_00000001.jpg,34,39,220,300,Peacoat,1,Upper Body,186,261,48546,train,8
82855,img/Double-Breasted_Peacoat/img_00000002.jpg,73,47,165,232,Peacoat,1,Upper Body,92,185,17020,train,8
82856,img/Double-Breasted_Peacoat/img_00000003.jpg,25,60,176,259,Peacoat,1,Upper Body,151,199,30049,train,8
82860,img/Double-Breasted_Peacoat/img_00000007.jpg,89,63,185,271,Peacoat,1,Upper Body,96,208,19968,train,8
82861,img/Double-Breasted_Peacoat/img_00000008.jpg,1,14,285,300,Peacoat,1,Upper Body,284,286,81224,train,8
82862,img/Double-Breasted_Peacoat/img_00000009.jpg,1,38,300,300,Peacoat,1,Upper Body,299,262,78338,train,8
82864,img/Double-Breasted_Peacoat/img_00000011.jpg,128,35,258,184,Peacoat,1,Upper Body,130,149,19370,train,8
82865,img/Double-Breasted_Peacoat/img_00000012.jpg,40,66,207,286,Peacoat,1,Upper Body,167,220,36740,train,8
82866,img/Double-Breasted_Peacoat/img_00000013.jpg,88,38,196,205,Peacoat,1,Upper Body,108,167,18036,train,8
82867,img/Double-Breasted_Peacoat/img_00000014.jpg,58,58,224,298,Peacoat,1,Upper Body,166,240,39840,train,8
82870,img/Double-Breasted_Peacoat/img_00000017.jpg,45,89,173,286,Peacoat,1,Upper Body,128,197,25216,train,8
82871,img/Double-Breasted_Peacoat/img_00000018.jpg,28,79,180,281,Peacoat,1,Upper Body,152,202,30704,train,8
82872,img/Double-Breasted_Peacoat/img_00000019.jpg,1,13,200,300,Peacoat,1,Upper Body,199,287,57113,train,8
82873,img/Double-Breasted_Peacoat/img_00000020.jpg,52,35,129,179,Peacoat,1,Upper Body,77,144,11088,train,8
82874,img/Double-Breasted_Peacoat/img_00000021.jpg,37,61,210,300,Peacoat,1,Upper Body,173,239,41347,train,8
82875,img/Double-Breasted_Peacoat/img_00000022.jpg,61,46,156,166,Peacoat,1,Upper Body,95,120,11400,train,8
82877,img/Double-Breasted_Peacoat/img_00000024.jpg,11,57,201,288,Peacoat,1,Upper Body,190,231,43890,train,8
82878,img/Double-Breasted_Peacoat/img_00000025.jpg,14,7,217,245,Peacoat,1,Upper Body,203,238,48314,train,8
82879,img/Double-Breasted_Peacoat/img_00000026.jpg,31,38,276,300,Peacoat,1,Upper Body,245,262,64190,train,8
82880,img/Double-Breasted_Peacoat/img_00000027.jpg,53,78,225,282,Peacoat,1,Upper Body,172,204,35088,train,8
82882,img/Double-Breasted_Peacoat/img_00000029.jpg,31,75,189,300,Peacoat,1,Upper Body,158,225,35550,train,8
82883,img/Double-Breasted_Peacoat/img_00000030.jpg,32,1,300,300,Peacoat,1,Upper Body,268,299,80132,train,8
82884,img/Double-Breasted_Peacoat/img_00000031.jpg,158,30,289,190,Peacoat,1,Upper Body,131,160,20960,train,8
82885,img/Double-Breasted_Peacoat/img_00000032.jpg,35,56,241,300,Peacoat,1,Upper Body,206,244,50264,train,8
82887,img/Double-Breasted_Peacoat/img_00000034.jpg,28,59,196,300,Peacoat,1,Upper Body,168,241,40488,train,8
82889,img/Double-Breasted_Peacoat/img_00000036.jpg,14,66,163,294,Peacoat,1,Upper Body,149,228,33972,train,8
82890,img/Double-Breasted_Peacoat/img_00000037.jpg,66,40,172,161,Peacoat,1,Upper Body,106,121,12826,train,8
82893,img/Double-Breasted_Peacoat/img_00000040.jpg,20,68,238,295,Peacoat,1,Upper Body,218,227,49486,train,8
82894,img/Double-Breasted_Peacoat/img_00000041.jpg,73,54,224,272,Peacoat,1,Upper Body,151,218,32918,train,8
82895,img/Double-Breasted_Peacoat/img_00000042.jpg,50,48,223,247,Peacoat,1,Upper Body,173,199,34427,train,8
82896,img/Double-Breasted_Peacoat/img_00000043.jpg,29,59,199,300,Peacoat,1,Upper Body,170,241,40970,train,8
82897,img/Double-Breasted_Peacoat/img_00000044.jpg,1,21,279,300,Peacoat,1,Upper Body,278,279,77562,train,8
82903,img/Double-Breasted_Peacoat/img_00000050.jpg,14,74,164,258,Peacoat,1,Upper Body,150,184,27600,train,8
82904,img/Double-Breasted_Peacoat/img_00000051.jpg,57,18,257,280,Peacoat,1,Upper Body,200,262,52400,train,8
82905,img/Double-Breasted_Peacoat/img_00000052.jpg,1,40,201,279,Peacoat,1,Upper Body,200,239,47800,train,8
82906,img/Double-Breasted_Peacoat/img_00000053.jpg,63,56,147,203,Peacoat,1,Upper Body,84,147,12348,train,8
82907,img/Double-Breasted_Peacoat/img_00000054.jpg,24,68,203,299,Peacoat,1,Upper Body,179,231,41349,train,8
82908,img/Double-Breasted_Peacoat/img_00000055.jpg,103,35,177,177,Peacoat,1,Upper Body,74,142,10508,train,8
82909,img/Double-Breasted_Peacoat/img_00000056.jpg,73,60,243,278,Peacoat,1,Upper Body,170,218,37060,train,8
82912,img/Double-Breasted_Peacoat/img_00000059.jpg,30,9,283,300,Peacoat,1,Upper Body,253,291,73623,train,8
82913,img/Double-Breasted_Peacoat/img_00000060.jpg,1,8,167,289,Peacoat,1,Upper Body,166,281,46646,train,8
82914,img/Double-Breasted_Peacoat/img_00000061.jpg,15,66,146,297,Peacoat,1,Upper Body,131,231,30261,train,8
82916,img/Double-Breasted_Peacoat/img_00000063.jpg,64,60,245,276,Peacoat,1,Upper Body,181,216,39096,train,8
82917,img/Double-Breasted_Peacoat/img_00000064.jpg,41,57,223,300,Peacoat,1,Upper Body,182,243,44226,train,8
82919,img/Double-Breasted_Peacoat/img_00000066.jpg,21,8,177,296,Peacoat,1,Upper Body,156,288,44928,train,8
82922,img/Double-Breasted_Peacoat/img_00000069.jpg,95,39,217,182,Peacoat,1,Upper Body,122,143,17446,train,8
82923,img/Double-Breasted_Peacoat/img_00000070.jpg,19,58,175,271,Peacoat,1,Upper Body,156,213,33228,train,8
82926,img/Double-Breasted_Peacoat/img_00000073.jpg,7,19,199,300,Peacoat,1,Upper Body,192,281,53952,train,8
82927,img/Double-Breasted_Peacoat/img_00000074.jpg,144,10,300,300,Peacoat,1,Upper Body,156,290,45240,train,8
82928,img/Double-Breasted_Peacoat/img_00000075.jpg,41,27,259,293,Peacoat,1,Upper Body,218,266,57988,train,8
82930,img/Double-Breasted_Peacoat/img_00000077.jpg,22,13,280,300,Peacoat,1,Upper Body,258,287,74046,train,8
82931,img/Double-Breasted_Peacoat/img_00000078.jpg,62,11,225,300,Peacoat,1,Upper Body,163,289,47107,train,8
82932,img/Double-Breasted_Peacoat/img_00000079.jpg,55,31,165,176,Peacoat,1,Upper Body,110,145,15950,train,8
82933,img/Double-Breasted_Peacoat/img_00000080.jpg,62,65,234,287,Peacoat,1,Upper Body,172,222,38184,train,8
82934,img/Double-Breasted_Peacoat/img_00000081.jpg,65,71,190,292,Peacoat,1,Upper Body,125,221,27625,train,8
82936,img/Double-Breasted_Peacoat/img_00000083.jpg,48,61,208,276,Peacoat,1,Upper Body,160,215,34400,train,8
82938,img/Double-Breasted_Peacoat/img_00000085.jpg,13,27,300,300,Peacoat,1,Upper Body,287,273,78351,train,8
82943,img/Double-Breasted_Peacoat/img_00000090.jpg,63,44,154,210,Peacoat,1,Upper Body,91,166,15106,train,8
82944,img/Double-Breasted_Peacoat/img_00000091.jpg,20,35,170,274,Peacoat,1,Upper Body,150,239,35850,train,8
82946,img/Double-Breasted_Peacoat/img_00000093.jpg,70,50,198,300,Peacoat,1,Upper Body,128,250,32000,train,8
82948,img/Double-Breasted_Peacoat/img_00000095.jpg,1,16,166,300,Peacoat,1,Upper Body,165,284,46860,train,8
82949,img/Double-Breasted_Peacoat/img_00000096.jpg,85,49,127,155,Peacoat,1,Upper Body,42,106,4452,train,8
82950,img/Double-Breasted_Peacoat/img_00000097.jpg,100,51,200,300,Peacoat,1,Upper Body,100,249,24900,train,8
134698,img/Ribbed_Knit_Turtleneck/img_00000002.jpg,23,61,172,202,Turtleneck,1,Upper Body,149,141,21009,train,10
134699,img/Ribbed_Knit_Turtleneck/img_00000003.jpg,1,5,300,200,Turtleneck,1,Upper Body,299,195,58305,train,10
134701,img/Ribbed_Knit_Turtleneck/img_00000005.jpg,10,1,252,300,Turtleneck,1,Upper Body,242,299,72358,train,10
134702,img/Ribbed_Knit_Turtleneck/img_00000006.jpg,1,67,300,300,Turtleneck,1,Upper Body,299,233,69667,train,10
134703,img/Ribbed_Knit_Turtleneck/img_00000007.jpg,25,75,196,300,Turtleneck,1,Upper Body,171,225,38475,train,10
134706,img/Ribbed_Knit_Turtleneck/img_00000011.jpg,13,1,209,286,Turtleneck,1,Upper Body,196,285,55860,train,10
134707,img/Ribbed_Knit_Turtleneck/img_00000012.jpg,28,46,172,285,Turtleneck,1,Upper Body,144,239,34416,train,10
134708,img/Ribbed_Knit_Turtleneck/img_00000013.jpg,1,44,215,300,Turtleneck,1,Upper Body,214,256,54784,train,10
134709,img/Ribbed_Knit_Turtleneck/img_00000014.jpg,74,24,169,153,Turtleneck,1,Upper Body,95,129,12255,train,10
134711,img/Ribbed_Knit_Turtleneck/img_00000016.jpg,53,55,185,272,Turtleneck,1,Upper Body,132,217,28644,train,10
134712,img/Ribbed_Knit_Turtleneck/img_00000017.jpg,1,45,164,286,Turtleneck,1,Upper Body,163,241,39283,train,10
134713,img/Ribbed_Knit_Turtleneck/img_00000018.jpg,6,48,120,158,Turtleneck,1,Upper Body,114,110,12540,train,10
134714,img/Ribbed_Knit_Turtleneck/img_00000019.jpg,6,49,188,300,Turtleneck,1,Upper Body,182,251,45682,train,10
134716,img/Ribbed_Knit_Turtleneck/img_00000021.jpg,146,1,300,239,Turtleneck,1,Upper Body,154,238,36652,train,10
134717,img/Ribbed_Knit_Turtleneck/img_00000022.jpg,15,1,175,300,Turtleneck,1,Upper Body,160,299,47840,train,10
134718,img/Ribbed_Knit_Turtleneck/img_00000023.jpg,79,1,159,165,Turtleneck,1,Upper Body,80,164,13120,train,10
134721,img/Ribbed_Knit_Turtleneck/img_00000026.jpg,77,57,204,300,Turtleneck,1,Upper Body,127,243,30861,train,10
134724,img/Ribbed_Knit_Turtleneck/img_00000029.jpg,38,47,187,275,Turtleneck,1,Upper Body,149,228,33972,train,10
134725,img/Ribbed_Knit_Turtleneck/img_00000030.jpg,37,1,272,300,Turtleneck,1,Upper Body,235,299,70265,train,10
134727,img/Ribbed_Knit_Turtleneck/img_00000032.jpg,1,33,200,293,Turtleneck,1,Upper Body,199,260,51740,train,10
134728,img/Ribbed_Knit_Turtleneck/img_00000033.jpg,61,1,156,140,Turtleneck,1,Upper Body,95,139,13205,train,10
134730,img/Ribbed_Knit_Turtleneck/img_00000035.jpg,92,71,207,300,Turtleneck,1,Upper Body,115,229,26335,train,10
170818,img/Frayed_Denim_Gauchos/img_00000001.jpg,31,75,89,138,Gauchos,2,Lower Body,58,63,3654,train,4
170819,img/Frayed_Denim_Gauchos/img_00000002.jpg,46,86,116,166,Gauchos,2,Lower Body,70,80,5600,train,4
170820,img/Frayed_Denim_Gauchos/img_00000003.jpg,54,1,197,226,Gauchos,2,Lower Body,143,225,32175,train,4
170822,img/Frayed_Denim_Gauchos/img_00000005.jpg,100,105,208,263,Gauchos,2,Lower Body,108,158,17064,train,4
170823,img/Frayed_Denim_Gauchos/img_00000006.jpg,97,1,200,234,Gauchos,2,Lower Body,103,233,23999,train,4
170824,img/Frayed_Denim_Gauchos/img_00000007.jpg,103,104,159,161,Gauchos,2,Lower Body,56,57,3192,train,4
170825,img/Frayed_Denim_Gauchos/img_00000008.jpg,1,1,200,221,Gauchos,2,Lower Body,199,220,43780,train,4
170826,img/Frayed_Denim_Gauchos/img_00000009.jpg,82,114,227,246,Gauchos,2,Lower Body,145,132,19140,train,4
170827,img/Frayed_Denim_Gauchos/img_00000010.jpg,200,105,260,192,Gauchos,2,Lower Body,60,87,5220,train,4
170828,img/Frayed_Denim_Gauchos/img_00000011.jpg,65,83,202,278,Gauchos,2,Lower Body,137,195,26715,train,4
170829,img/Frayed_Denim_Gauchos/img_00000012.jpg,41,1,281,286,Gauchos,2,Lower Body,240,285,68400,train,4
170830,img/Frayed_Denim_Gauchos/img_00000013.jpg,196,102,262,167,Gauchos,2,Lower Body,66,65,4290,train,4
170831,img/Frayed_Denim_Gauchos/img_00000014.jpg,1,1,300,300,Gauchos,2,Lower Body,299,299,89401,train,4
170832,img/Frayed_Denim_Gauchos/img_00000015.jpg,89,101,198,276,Gauchos,2,Lower Body,109,175,19075,train,4
170833,img/Frayed_Denim_Gauchos/img_00000016.jpg,36,154,149,242,Gauchos,2,Lower Body,113,88,9944,train,4
170834,img/Frayed_Denim_Gauchos/img_00000017.jpg,1,1,300,300,Gauchos,2,Lower Body,299,299,89401,train,4
170835,img/Frayed_Denim_Gauchos/img_00000018.jpg,52,83,119,128,Gauchos,2,Lower Body,67,45,3015,train,4
170836,img/Frayed_Denim_Gauchos/img_00000019.jpg,20,71,99,202,Gauchos,2,Lower Body,79,131,10349,train,4
170837,img/Frayed_Denim_Gauchos/img_00000020.jpg,41,1,144,270,Gauchos,2,Lower Body,103,269,27707,train,4
170839,img/Frayed_Denim_Gauchos/img_00000022.jpg,68,5,163,64,Gauchos,2,Lower Body,95,59,5605,train,4
170842,img/Frayed_Denim_Gauchos/img_00000025.jpg,83,124,171,300,Gauchos,2,Lower Body,88,176,15488,train,4
170843,img/Frayed_Denim_Gauchos/img_00000026.jpg,54,96,139,262,Gauchos,2,Lower Body,85,166,14110,train,4
170844,img/Frayed_Denim_Gauchos/img_00000027.jpg,53,1,139,239,Gauchos,2,Lower Body,86,238,20468,train,4
170847,img/Frayed_Denim_Gauchos/img_00000030.jpg,1,182,196,300,Gauchos,2,Lower Body,195,118,23010,train,4
170848,img/Frayed_Denim_Gauchos/img_00000031.jpg,47,105,102,263,Gauchos,2,Lower Body,55,158,8690,train,4
170849,img/Frayed_Denim_Gauchos/img_00000032.jpg,80,1,217,212,Gauchos,2,Lower Body,137,211,28907,train,4
170854,img/Frayed_Denim_Gauchos/img_00000037.jpg,57,82,122,253,Gauchos,2,Lower Body,65,171,11115,train,4
170855,img/Frayed_Denim_Gauchos/img_00000038.jpg,147,76,219,174,Gauchos,2,Lower Body,72,98,7056,train,4
170856,img/Frayed_Denim_Gauchos/img_00000039.jpg,1,60,299,300,Gauchos,2,Lower Body,298,240,71520,train,4
170858,img/Frayed_Denim_Gauchos/img_00000041.jpg,7,41,195,174,Gauchos,2,Lower Body,188,133,25004,train,4
170859,img/Frayed_Denim_Gauchos/img_00000042.jpg,141,85,215,203,Gauchos,2,Lower Body,74,118,8732,train,4
170861,img/Frayed_Denim_Gauchos/img_00000044.jpg,78,1,194,83,Gauchos,2,Lower Body,116,82,9512,train,4
170862,img/Frayed_Denim_Gauchos/img_00000045.jpg,43,75,93,171,Gauchos,2,Lower Body,50,96,4800,train,4
170863,img/Frayed_Denim_Gauchos/img_00000046.jpg,27,1,148,185,Gauchos,2,Lower Body,121,184,22264,train,4
170865,img/Frayed_Denim_Gauchos/img_00000048.jpg,104,120,174,276,Gauchos,2,Lower Body,70,156,10920,train,4
173203,img/Topstitched_Jodhpurs/img_00000001.jpg,63,117,149,251,Jodhpurs,2,Lower Body,86,134,11524,train,5
173206,img/Topstitched_Jodhpurs/img_00000004.jpg,81,89,143,272,Jodhpurs,2,Lower Body,62,183,11346,train,5
173207,img/Topstitched_Jodhpurs/img_00000005.jpg,1,127,200,300,Jodhpurs,2,Lower Body,199,173,34427,train,5
173208,img/Topstitched_Jodhpurs/img_00000006.jpg,1,185,205,300,Jodhpurs,2,Lower Body,204,115,23460,train,5
173210,img/Topstitched_Jodhpurs/img_00000008.jpg,42,115,134,261,Jodhpurs,2,Lower Body,92,146,13432,train,5
173211,img/Topstitched_Jodhpurs/img_00000009.jpg,87,97,110,290,Jodhpurs,2,Lower Body,23,193,4439,train,5
173214,img/Topstitched_Jodhpurs/img_00000012.jpg,56,103,136,266,Jodhpurs,2,Lower Body,80,163,13040,train,5
173215,img/Topstitched_Jodhpurs/img_00000013.jpg,4,91,112,270,Jodhpurs,2,Lower Body,108,179,19332,train,5
173216,img/Topstitched_Jodhpurs/img_00000014.jpg,57,101,160,270,Jodhpurs,2,Lower Body,103,169,17407,train,5
173218,img/Topstitched_Jodhpurs/img_00000016.jpg,87,117,145,277,Jodhpurs,2,Lower Body,58,160,9280,train,5
173220,img/Topstitched_Jodhpurs/img_00000018.jpg,149,99,207,273,Jodhpurs,2,Lower Body,58,174,10092,train,5
173222,img/Topstitched_Jodhpurs/img_00000020.jpg,50,19,150,278,Jodhpurs,2,Lower Body,100,259,25900,train,5
173224,img/Topstitched_Jodhpurs/img_00000022.jpg,49,112,137,279,Jodhpurs,2,Lower Body,88,167,14696,train,5
173225,img/Topstitched_Jodhpurs/img_00000023.jpg,1,18,200,277,Jodhpurs,2,Lower Body,199,259,51541,train,5
173226,img/Topstitched_Jodhpurs/img_00000024.jpg,133,121,170,281,Jodhpurs,2,Lower Body,37,160,5920,train,5
173227,img/Topstitched_Jodhpurs/img_00000025.jpg,42,88,136,300,Jodhpurs,2,Lower Body,94,212,19928,train,5
173228,img/Topstitched_Jodhpurs/img_00000026.jpg,48,121,139,293,Jodhpurs,2,Lower Body,91,172,15652,train,5
173229,img/Topstitched_Jodhpurs/img_00000027.jpg,119,111,177,278,Jodhpurs,2,Lower Body,58,167,9686,train,5
173230,img/Topstitched_Jodhpurs/img_00000028.jpg,1,187,204,300,Jodhpurs,2,Lower Body,203,113,22939,train,5
173231,img/Topstitched_Jodhpurs/img_00000029.jpg,60,87,118,151,Jodhpurs,2,Lower Body,58,64,3712,train,5
173232,img/Topstitched_Jodhpurs/img_00000030.jpg,1,121,106,170,Jodhpurs,2,Lower Body,105,49,5145,train,5
173233,img/Topstitched_Jodhpurs/img_00000031.jpg,66,106,143,259,Jodhpurs,2,Lower Body,77,153,11781,train,5
173234,img/Topstitched_Jodhpurs/img_00000032.jpg,110,123,158,285,Jodhpurs,2,Lower Body,48,162,7776,train,5
173235,img/Topstitched_Jodhpurs/img_00000033.jpg,1,141,200,300,Jodhpurs,2,Lower Body,199,159,31641,train,5
173236,img/Topstitched_Jodhpurs/img_00000034.jpg,57,1,142,269,Jodhpurs,2,Lower Body,85,268,22780,train,5
173237,img/Topstitched_Jodhpurs/img_00000035.jpg,50,1,158,280,Jodhpurs,2,Lower Body,108,279,30132,train,5
173239,img/Topstitched_Jodhpurs/img_00000037.jpg,87,106,101,279,Jodhpurs,2,Lower Body,14,173,2422,train,5
173240,img/Topstitched_Jodhpurs/img_00000038.jpg,1,202,200,300,Jodhpurs,2,Lower Body,199,98,19502,train,5
188216,img/Topstitched_Jodhpurs/img_00000039.jpg,245,1,300,143,Jodhpurs,2,Lower Body,55,142,7810,train,5
188219,img/Topstitched_Jodhpurs/img_00000042.jpg,77,85,125,227,Jodhpurs,2,Lower Body,48,142,6816,train,5
188220,img/Topstitched_Jodhpurs/img_00000043.jpg,79,101,135,272,Jodhpurs,2,Lower Body,56,171,9576,train,5
188222,img/Topstitched_Jodhpurs/img_00000045.jpg,72,101,128,273,Jodhpurs,2,Lower Body,56,172,9632,train,5
188638,img/Drawstring_Cargo_Capris/img_00000001.jpg,78,1,229,291,Capris,2,Lower Body,151,290,43790,train,3
188639,img/Drawstring_Cargo_Capris/img_00000002.jpg,30,17,157,258,Capris,2,Lower Body,127,241,30607,train,3
188640,img/Drawstring_Cargo_Capris/img_00000003.jpg,24,1,202,300,Capris,2,Lower Body,178,299,53222,train,3
188641,img/Drawstring_Cargo_Capris/img_00000004.jpg,87,1,217,300,Capris,2,Lower Body,130,299,38870,train,3
188642,img/Drawstring_Cargo_Capris/img_00000005.jpg,66,1,230,214,Capris,2,Lower Body,164,213,34932,train,3
188644,img/Drawstring_Cargo_Capris/img_00000007.jpg,17,1,99,253,Capris,2,Lower Body,82,252,20664,train,3
188645,img/Drawstring_Cargo_Capris/img_00000008.jpg,38,1,202,227,Capris,2,Lower Body,164,226,37064,train,3
188646,img/Drawstring_Cargo_Capris/img_00000009.jpg,62,1,183,280,Capris,2,Lower Body,121,279,33759,train,3
188647,img/Drawstring_Cargo_Capris/img_00000010.jpg,46,1,177,229,Capris,2,Lower Body,131,228,29868,train,3
188649,img/Drawstring_Cargo_Capris/img_00000012.jpg,42,1,203,267,Capris,2,Lower Body,161,266,42826,train,3
188650,img/Drawstring_Cargo_Capris/img_00000013.jpg,55,1,169,279,Capris,2,Lower Body,114,278,31692,train,3
188651,img/Drawstring_Cargo_Capris/img_00000014.jpg,1,5,103,209,Capris,2,Lower Body,102,204,20808,train,3
188652,img/Drawstring_Cargo_Capris/img_00000015.jpg,75,1,218,288,Capris,2,Lower Body,143,287,41041,train,3
188653,img/Drawstring_Cargo_Capris/img_00000016.jpg,42,1,202,277,Capris,2,Lower Body,160,276,44160,train,3
188660,img/Drawstring_Cargo_Capris/img_00000023.jpg,62,1,241,300,Capris,2,Lower Body,179,299,53521,train,3
188661,img/Drawstring_Cargo_Capris/img_00000024.jpg,49,1,251,274,Capris,2,Lower Body,202,273,55146,train,3
188663,img/Drawstring_Cargo_Capris/img_00000026.jpg,30,1,211,293,Capris,2,Lower Body,181,292,52852,train,3
188664,img/Drawstring_Cargo_Capris/img_00000027.jpg,56,10,201,294,Capris,2,Lower Body,145,284,41180,train,3
188667,img/Drawstring_Cargo_Capris/img_00000030.jpg,71,1,174,240,Capris,2,Lower Body,103,239,24617,train,3
188668,img/Drawstring_Cargo_Capris/img_00000031.jpg,88,32,220,271,Capris,2,Lower Body,132,239,31548,train,3
188669,img/Drawstring_Cargo_Capris/img_00000032.jpg,59,1,233,276,Capris,2,Lower Body,174,275,47850,train,3
188670,img/Drawstring_Cargo_Capris/img_00000033.jpg,1,1,212,300,Capris,2,Lower Body,211,299,63089,train,3
188671,img/Drawstring_Cargo_Capris/img_00000034.jpg,32,1,206,296,Capris,2,Lower Body,174,295,51330,train,3
188672,img/Drawstring_Cargo_Capris/img_00000035.jpg,17,1,298,300,Capris,2,Lower Body,281,299,84019,train,3
188673,img/Drawstring_Cargo_Capris/img_00000036.jpg,1,1,190,300,Capris,2,Lower Body,189,299,56511,train,3
188674,img/Drawstring_Cargo_Capris/img_00000037.jpg,1,1,233,300,Capris,2,Lower Body,232,299,69368,train,3
188675,img/Drawstring_Cargo_Capris/img_00000038.jpg,1,1,300,300,Capris,2,Lower Body,299,299,89401,train,3
188676,img/Drawstring_Cargo_Capris/img_00000039.jpg,83,1,228,300,Capris,2,Lower Body,145,299,43355,train,3
188677,img/Drawstring_Cargo_Capris/img_00000040.jpg,1,1,130,208,Capris,2,Lower Body,129,207,26703,train,3
188679,img/Drawstring_Cargo_Capris/img_00000042.jpg,1,1,201,300,Capris,2,Lower Body,200,299,59800,train,3
188681,img/Drawstring_Cargo_Capris/img_00000044.jpg,1,1,236,256,Capris,2,Lower Body,235,255,59925,train,3
188682,img/Drawstring_Cargo_Capris/img_00000045.jpg,57,1,256,300,Capris,2,Lower Body,199,299,59501,train,3
188683,img/Drawstring_Cargo_Capris/img_00000046.jpg,25,8,200,289,Capris,2,Lower Body,175,281,49175,train,3
188685,img/Drawstring_Cargo_Capris/img_00000048.jpg,1,1,148,300,Capris,2,Lower Body,147,299,43953,train,3
188686,img/Drawstring_Cargo_Capris/img_00000049.jpg,3,1,127,293,Capris,2,Lower Body,124,292,36208,train,3
188687,img/Drawstring_Cargo_Capris/img_00000050.jpg,55,1,114,260,Capris,2,Lower Body,59,259,15281,train,3
188688,img/Drawstring_Cargo_Capris/img_00000051.jpg,102,11,208,217,Capris,2,Lower Body,106,206,21836,train,3
188689,img/Drawstring_Cargo_Capris/img_00000052.jpg,70,1,176,287,Capris,2,Lower Body,106,286,30316,train,3
188692,img/Drawstring_Cargo_Capris/img_00000055.jpg,87,1,225,287,Capris,2,Lower Body,138,286,39468,train,3
188694,img/Drawstring_Cargo_Capris/img_00000057.jpg,46,1,184,238,Capris,2,Lower Body,138,237,32706,train,3
188695,img/Drawstring_Cargo_Capris/img_00000058.jpg,1,1,112,206,Capris,2,Lower Body,111,205,22755,train,3
188696,img/Drawstring_Cargo_Capris/img_00000059.jpg,1,29,165,300,Capris,2,Lower Body,164,271,44444,train,3
188697,img/Drawstring_Cargo_Capris/img_00000060.jpg,20,1,176,205,Capris,2,Lower Body,156,204,31824,train,3
188698,img/Drawstring_Cargo_Capris/img_00000061.jpg,1,1,225,291,Capris,2,Lower Body,224,290,64960,train,3
188699,img/Drawstring_Cargo_Capris/img_00000062.jpg,9,1,175,300,Capris,2,Lower Body,166,299,49634,train,3
188701,img/Drawstring_Cargo_Capris/img_00000064.jpg,3,6,157,293,Capris,2,Lower Body,154,287,44198,train,3
188702,img/Drawstring_Cargo_Capris/img_00000065.jpg,46,1,188,233,Capris,2,Lower Body,142,232,32944,train,3
188703,img/Drawstring_Cargo_Capris/img_00000066.jpg,1,1,169,225,Capris,2,Lower Body,168,224,37632,train,3
188704,img/Drawstring_Cargo_Capris/img_00000067.jpg,67,1,234,300,Capris,2,Lower Body,167,299,49933,train,3
188705,img/Drawstring_Cargo_Capris/img_00000068.jpg,44,1,190,156,Capris,2,Lower Body,146,155,22630,train,3
188706,img/Drawstring_Cargo_Capris/img_00000069.jpg,121,114,188,246,Capris,2,Lower Body,67,132,8844,train,3
188708,img/Drawstring_Cargo_Capris/img_00000071.jpg,30,1,164,218,Capris,2,Lower Body,134,217,29078,train,3
188709,img/Drawstring_Cargo_Capris/img_00000072.jpg,1,1,300,300,Capris,2,Lower Body,299,299,89401,train,3
188710,img/Drawstring_Cargo_Capris/img_00000073.jpg,84,1,182,277,Capris,2,Lower Body,98,276,27048,train,3
188711,img/Drawstring_Cargo_Capris/img_00000074.jpg,23,1,245,231,Capris,2,Lower Body,222,230,51060,train,3
188712,img/Drawstring_Cargo_Capris/img_00000075.jpg,73,23,183,299,Capris,2,Lower Body,110,276,30360,train,3
188713,img/Drawstring_Cargo_Capris/img_00000076.jpg,31,1,300,300,Capris,2,Lower Body,269,299,80431,train,3
240494,img/Lace-Paneled_Satin_Robe/img_00000002.jpg,83,25,193,150,Robe,3,Full Body,110,125,13750,train,9
240495,img/Lace-Paneled_Satin_Robe/img_00000003.jpg,112,30,170,116,Robe,3,Full Body,58,86,4988,train,9
240496,img/Lace-Paneled_Satin_Robe/img_00000004.jpg,1,32,208,261,Robe,3,Full Body,207,229,47403,train,9
240497,img/Lace-Paneled_Satin_Robe/img_00000005.jpg,58,40,143,153,Robe,3,Full Body,85,113,9605,train,9
240499,img/Lace-Paneled_Satin_Robe/img_00000007.jpg,1,1,200,300,Robe,3,Full Body,199,299,59501,train,9
240500,img/Lace-Paneled_Satin_Robe/img_00000008.jpg,1,1,210,149,Robe,3,Full Body,209,148,30932,train,9
240501,img/Lace-Paneled_Satin_Robe/img_00000009.jpg,1,49,300,300,Robe,3,Full Body,299,251,75049,train,9
240502,img/Lace-Paneled_Satin_Robe/img_00000010.jpg,108,31,188,205,Robe,3,Full Body,80,174,13920,train,9
240503,img/Lace-Paneled_Satin_Robe/img_00000011.jpg,1,46,200,267,Robe,3,Full Body,199,221,43979,train,9
240504,img/Lace-Paneled_Satin_Robe/img_00000012.jpg,32,26,104,134,Robe,3,Full Body,72,108,7776,train,9
240505,img/Lace-Paneled_Satin_Robe/img_00000013.jpg,35,8,256,286,Robe,3,Full Body,221,278,61438,train,9
240506,img/Lace-Paneled_Satin_Robe/img_00000014.jpg,1,53,203,262,Robe,3,Full Body,202,209,42218,train,9
240509,img/Lace-Paneled_Satin_Robe/img_00000017.jpg,6,56,225,297,Robe,3,Full Body,219,241,52779,train,9
240510,img/Lace-Paneled_Satin_Robe/img_00000019.jpg,34,50,188,291,Robe,3,Full Body,154,241,37114,train,9
240512,img/Lace-Paneled_Satin_Robe/img_00000021.jpg,67,33,158,187,Robe,3,Full Body,91,154,14014,train,9
240514,img/Lace-Paneled_Satin_Robe/img_00000023.jpg,27,1,179,300,Robe,3,Full Body,152,299,45448,train,9
240515,img/Lace-Paneled_Satin_Robe/img_00000024.jpg,58,54,166,294,Robe,3,Full Body,108,240,25920,train,9
240516,img/Lace-Paneled_Satin_Robe/img_00000025.jpg,1,15,175,242,Robe,3,Full Body,174,227,39498,train,9
240519,img/Lace-Paneled_Satin_Robe/img_00000028.jpg,46,52,185,300,Robe,3,Full Body,139,248,34472,train,9
240520,img/Lace-Paneled_Satin_Robe/img_00000029.jpg,1,1,200,300,Robe,3,Full Body,199,299,59501,train,9
240521,img/Lace-Paneled_Satin_Robe/img_00000030.jpg,21,4,171,300,Robe,3,Full Body,150,296,44400,train,9
240522,img/Lace-Paneled_Satin_Robe/img_00000031.jpg,72,23,222,229,Robe,3,Full Body,150,206,30900,train,9
240523,img/Lace-Paneled_Satin_Robe/img_00000032.jpg,47,28,131,284,Robe,3,Full Body,84,256,21504,train,9
240524,img/Lace-Paneled_Satin_Robe/img_00000033.jpg,68,23,153,219,Robe,3,Full Body,85,196,16660,train,9
240526,img/Lace-Paneled_Satin_Robe/img_00000035.jpg,39,66,155,281,Robe,3,Full Body,116,215,24940,train,9
240528,img/Lace-Paneled_Satin_Robe/img_00000037.jpg,21,1,200,300,Robe,3,Full Body,179,299,53521,train,9
240529,img/Lace-Paneled_Satin_Robe/img_00000038.jpg,1,127,300,300,Robe,3,Full Body,299,173,51727,train,9
240530,img/Lace-Paneled_Satin_Robe/img_00000039.jpg,23,48,240,300,Robe,3,Full Body,217,252,54684,train,9
240532,img/Lace-Paneled_Satin_Robe/img_00000041.jpg,39,34,181,239,Robe,3,Full Body,142,205,29110,train,9
240533,img/Lace-Paneled_Satin_Robe/img_00000042.jpg,89,25,190,300,Robe,3,Full Body,101,275,27775,train,9
240534,img/Lace-Paneled_Satin_Robe/img_00000043.jpg,1,4,136,136,Robe,3,Full Body,135,132,17820,train,9
240535,img/Lace-Paneled_Satin_Robe/img_00000044.jpg,56,30,156,177,Robe,3,Full Body,100,147,14700,train,9
240536,img/Lace-Paneled_Satin_Robe/img_00000045.jpg,46,25,155,300,Robe,3,Full Body,109,275,29975,train,9
240538,img/Lace-Paneled_Satin_Robe/img_00000047.jpg,1,83,225,300,Robe,3,Full Body,224,217,48608,train,9
240539,img/Lace-Paneled_Satin_Robe/img_00000048.jpg,17,53,198,300,Robe,3,Full Body,181,247,44707,train,9
240541,img/Lace-Paneled_Satin_Robe/img_00000050.jpg,9,20,61,95,Robe,3,Full Body,52,75,3900,train,9
240542,img/Lace-Paneled_Satin_Robe/img_00000051.jpg,96,34,170,213,Robe,3,Full Body,74,179,13246,train,9
243893,img/Tile_Print_Drawstring_Caftan/img_00000001.jpg,1,1,300,300,Caftan,3,Full Body,299,299,89401,train,2
243894,img/Tile_Print_Drawstring_Caftan/img_00000002.jpg,258,188,300,295,Caftan,3,Full Body,42,107,4494,train,2
243895,img/Tile_Print_Drawstring_Caftan/img_00000003.jpg,15,1,233,297,Caftan,3,Full Body,218,296,64528,train,2
243896,img/Tile_Print_Drawstring_Caftan/img_00000004.jpg,57,1,194,263,Caftan,3,Full Body,137,262,35894,train,2
243897,img/Tile_Print_Drawstring_Caftan/img_00000005.jpg,34,48,179,286,Caftan,3,Full Body,145,238,34510,train,2
243898,img/Tile_Print_Drawstring_Caftan/img_00000006.jpg,5,1,300,300,Caftan,3,Full Body,295,299,88205,train,2
243899,img/Tile_Print_Drawstring_Caftan/img_00000007.jpg,1,7,189,290,Caftan,3,Full Body,188,283,53204,train,2
243900,img/Tile_Print_Drawstring_Caftan/img_00000008.jpg,27,1,279,300,Caftan,3,Full Body,252,299,75348,train,2
243903,img/Tile_Print_Drawstring_Caftan/img_00000011.jpg,107,36,203,253,Caftan,3,Full Body,96,217,20832,train,2
243904,img/Tile_Print_Drawstring_Caftan/img_00000012.jpg,25,1,289,300,Caftan,3,Full Body,264,299,78936,train,2
243905,img/Tile_Print_Drawstring_Caftan/img_00000013.jpg,42,32,150,296,Caftan,3,Full Body,108,264,28512,train,2
243908,img/Tile_Print_Drawstring_Caftan/img_00000016.jpg,46,51,218,300,Caftan,3,Full Body,172,249,42828,train,2
243910,img/Tile_Print_Drawstring_Caftan/img_00000018.jpg,85,37,221,190,Caftan,3,Full Body,136,153,20808,train,2
243912,img/Tile_Print_Drawstring_Caftan/img_00000020.jpg,54,21,205,300,Caftan,3,Full Body,151,279,42129,train,2
243913,img/Tile_Print_Drawstring_Caftan/img_00000021.jpg,93,36,166,187,Caftan,3,Full Body,73,151,11023,train,2
243914,img/Tile_Print_Drawstring_Caftan/img_00000022.jpg,52,32,170,278,Caftan,3,Full Body,118,246,29028,train,2
243915,img/Tile_Print_Drawstring_Caftan/img_00000023.jpg,20,3,148,210,Caftan,3,Full Body,128,207,26496,train,2
243916,img/Tile_Print_Drawstring_Caftan/img_00000024.jpg,53,39,226,244,Caftan,3,Full Body,173,205,35465,train,2
243922,img/Tile_Print_Drawstring_Caftan/img_00000030.jpg,79,24,231,300,Caftan,3,Full Body,152,276,41952,train,2
243923,img/Tile_Print_Drawstring_Caftan/img_00000031.jpg,63,36,202,267,Caftan,3,Full Body,139,231,32109,train,2
243924,img/Tile_Print_Drawstring_Caftan/img_00000032.jpg,41,1,265,300,Caftan,3,Full Body,224,299,66976,train,2
243925,img/Tile_Print_Drawstring_Caftan/img_00000033.jpg,43,38,164,234,Caftan,3,Full Body,121,196,23716,train,2
243927,img/Tile_Print_Drawstring_Caftan/img_00000035.jpg,1,39,106,204,Caftan,3,Full Body,105,165,17325,train,2
243928,img/Tile_Print_Drawstring_Caftan/img_00000036.jpg,8,46,259,300,Caftan,3,Full Body,251,254,63754,train,2
243929,img/Tile_Print_Drawstring_Caftan/img_00000037.jpg,81,36,220,300,Caftan,3,Full Body,139,264,36696,train,2
243930,img/Tile_Print_Drawstring_Caftan/img_00000038.jpg,58,28,146,163,Caftan,3,Full Body,88,135,11880,train,2
243931,img/Tile_Print_Drawstring_Caftan/img_00000039.jpg,1,36,300,300,Caftan,3,Full Body,299,264,78936,train,2
243932,img/Tile_Print_Drawstring_Caftan/img_00000040.jpg,47,32,250,272,Caftan,3,Full Body,203,240,48720,train,2
243933,img/Tile_Print_Drawstring_Caftan/img_00000041.jpg,115,25,187,300,Caftan,3,Full Body,72,275,19800,train,2
243935,img/Tile_Print_Drawstring_Caftan/img_00000043.jpg,70,53,221,300,Caftan,3,Full Body,151,247,37297,train,2
243936,img/Tile_Print_Drawstring_Caftan/img_00000044.jpg,1,18,300,300,Caftan,3,Full Body,299,282,84318,train,2
243938,img/Tile_Print_Drawstring_Caftan/img_00000046.jpg,59,32,244,197,Caftan,3,Full Body,185,165,30525,train,2
243939,img/Tile_Print_Drawstring_Caftan/img_00000047.jpg,61,60,243,294,Caftan,3,Full Body,182,234,42588,train,2
243940,img/Tile_Print_Drawstring_Caftan/img_00000048.jpg,1,5,300,300,Caftan,3,Full Body,299,295,88205,train,2
243942,img/Tile_Print_Drawstring_Caftan/img_00000050.jpg,77,19,213,300,Caftan,3,Full Body,136,281,38216,train,2
243943,img/Tile_Print_Drawstring_Caftan/img_00000051.jpg,1,1,300,300,Caftan,3,Full Body,299,299,89401,train,2
243944,img/Tile_Print_Drawstring_Caftan/img_00000052.jpg,12,56,186,300,Caftan,3,Full Body,174,244,42456,train,2
243945,img/Tile_Print_Drawstring_Caftan/img_00000053.jpg,85,29,207,292,Caftan,3,Full Body,122,263,32086,train,2
250163,img/Plush_Polka_Dot_Robe/img_00000002.jpg,29,44,173,296,Robe,3,Full Body,144,252,36288,train,9
250164,img/Plush_Polka_Dot_Robe/img_00000003.jpg,70,40,194,237,Robe,3,Full Body,124,197,24428,train,9
250165,img/Plush_Polka_Dot_Robe/img_00000004.jpg,30,2,137,221,Robe,3,Full Body,107,219,23433,train,9
250166,img/Plush_Polka_Dot_Robe/img_00000005.jpg,1,24,86,254,Robe,3,Full Body,85,230,19550,train,9
250167,img/Plush_Polka_Dot_Robe/img_00000006.jpg,33,1,277,225,Robe,3,Full Body,244,224,54656,train,9
250169,img/Plush_Polka_Dot_Robe/img_00000008.jpg,33,36,111,170,Robe,3,Full Body,78,134,10452,train,9
250170,img/Plush_Polka_Dot_Robe/img_00000009.jpg,17,2,153,225,Robe,3,Full Body,136,223,30328,train,9
250175,img/Plush_Polka_Dot_Robe/img_00000014.jpg,77,1,231,281,Robe,3,Full Body,154,280,43120,train,9
250176,img/Plush_Polka_Dot_Robe/img_00000015.jpg,1,1,196,297,Robe,3,Full Body,195,296,57720,train,9
250178,img/Plush_Polka_Dot_Robe/img_00000017.jpg,1,32,250,300,Robe,3,Full Body,249,268,66732,train,9
250179,img/Plush_Polka_Dot_Robe/img_00000018.jpg,109,29,210,231,Robe,3,Full Body,101,202,20402,train,9
250181,img/Plush_Polka_Dot_Robe/img_00000020.jpg,49,41,156,208,Robe,3,Full Body,107,167,17869,train,9
250182,img/Plush_Polka_Dot_Robe/img_00000021.jpg,23,27,141,265,Robe,3,Full Body,118,238,28084,train,9
250183,img/Plush_Polka_Dot_Robe/img_00000022.jpg,61,34,156,212,Robe,3,Full Body,95,178,16910,train,9
250184,img/Plush_Polka_Dot_Robe/img_00000023.jpg,89,1,227,176,Robe,3,Full Body,138,175,24150,train,9
250185,img/Plush_Polka_Dot_Robe/img_00000024.jpg,47,5,191,267,Robe,3,Full Body,144,262,37728,train,9
250186,img/Plush_Polka_Dot_Robe/img_00000025.jpg,22,49,174,300,Robe,3,Full Body,152,251,38152,train,9
250187,img/Plush_Polka_Dot_Robe/img_00000026.jpg,90,29,206,264,Robe,3,Full Body,116,235,27260,train,9
250188,img/Plush_Polka_Dot_Robe/img_00000027.jpg,81,33,163,217,Robe,3,Full Body,82,184,15088,train,9
250189,img/Plush_Polka_Dot_Robe/img_00000028.jpg,22,1,286,300,Robe,3,Full Body,264,299,78936,train,9
250190,img/Plush_Polka_Dot_Robe/img_00000029.jpg,172,34,282,193,Robe,3,Full Body,110,159,17490,train,9
250192,img/Plush_Polka_Dot_Robe/img_00000031.jpg,30,36,161,236,Robe,3,Full Body,131,200,26200,train,9
250193,img/Plush_Polka_Dot_Robe/img_00000032.jpg,1,44,111,207,Robe,3,Full Body,110,163,17930,train,9
250195,img/Plush_Polka_Dot_Robe/img_00000034.jpg,100,1,213,193,Robe,3,Full Body,113,192,21696,train,9
250197,img/Plush_Polka_Dot_Robe/img_00000036.jpg,1,1,203,300,Robe,3,Full Body,202,299,60398,train,9
250198,img/Plush_Polka_Dot_Robe/img_00000037.jpg,91,27,215,186,Robe,3,Full Body,124,159,19716,train,9
250199,img/Plush_Polka_Dot_Robe/img_00000038.jpg,1,1,161,300,Robe,3,Full Body,160,299,47840,train,9
250202,img/Plush_Polka_Dot_Robe/img_00000041.jpg,65,2,199,300,Robe,3,Full Body,134,298,39932,train,9
250205,img/Plush_Polka_Dot_Robe/img_00000044.jpg,85,1,193,211,Robe,3,Full Body,108,210,22680,train,9
250206,img/Plush_Polka_Dot_Robe/img_00000045.jpg,1,67,300,300,Robe,3,Full Body,299,233,69667,train,9
250207,img/Plush_Polka_Dot_Robe/img_00000046.jpg,1,1,300,300,Robe,3,Full Body,299,299,89401,train,9
250208,img/Plush_Polka_Dot_Robe/img_00000047.jpg,165,36,296,247,Robe,3,Full Body,131,211,27641,train,9
250209,img/Plush_Polka_Dot_Robe/img_00000048.jpg,1,1,300,241,Robe,3,Full Body,299,240,71760,train,9
250210,img/Plush_Polka_Dot_Robe/img_00000049.jpg,43,1,223,295,Robe,3,Full Body,180,294,52920,train,9
250211,img/Plush_Polka_Dot_Robe/img_00000050.jpg,56,1,200,271,Robe,3,Full Body,144,270,38880,train,9
250212,img/Plush_Polka_Dot_Robe/img_00000051.jpg,68,31,162,167,Robe,3,Full Body,94,136,12784,train,9
250215,img/Plush_Polka_Dot_Robe/img_00000054.jpg,24,1,112,160,Robe,3,Full Body,88,159,13992,train,9
250216,img/Plush_Polka_Dot_Robe/img_00000055.jpg,1,48,300,300,Robe,3,Full Body,299,252,75348,train,9
250217,img/Plush_Polka_Dot_Robe/img_00000056.jpg,76,36,174,232,Robe,3,Full Body,98,196,19208,train,9
250218,img/Plush_Polka_Dot_Robe/img_00000057.jpg,21,26,179,300,Robe,3,Full Body,158,274,43292,train,9
250219,img/Plush_Polka_Dot_Robe/img_00000058.jpg,95,29,195,226,Robe,3,Full Body,100,197,19700,train,9
250221,img/Plush_Polka_Dot_Robe/img_00000060.jpg,1,1,184,300,Robe,3,Full Body,183,299,54717,train,9
250223,img/Plush_Polka_Dot_Robe/img_00000062.jpg,67,28,162,200,Robe,3,Full Body,95,172,16340,train,9
250226,img/Plush_Polka_Dot_Robe/img_00000065.jpg,53,1,268,281,Robe,3,Full Body,215,280,60200,train,9
250227,img/Plush_Polka_Dot_Robe/img_00000066.jpg,1,19,300,298,Robe,3,Full Body,299,279,83421,train,9
250228,img/Plush_Polka_Dot_Robe/img_00000067.jpg,1,26,300,300,Robe,3,Full Body,299,274,81926,train,9
258233,img/Tribal_Print_V-Back_Kaftan/img_00000001.jpg,51,61,137,218,Kaftan,3,Full Body,86,157,13502,train,6
258234,img/Tribal_Print_V-Back_Kaftan/img_00000002.jpg,51,50,251,273,Kaftan,3,Full Body,200,223,44600,train,6
258235,img/Tribal_Print_V-Back_Kaftan/img_00000003.jpg,34,21,152,214,Kaftan,3,Full Body,118,193,22774,train,6
258236,img/Tribal_Print_V-Back_Kaftan/img_00000004.jpg,48,17,175,300,Kaftan,3,Full Body,127,283,35941,train,6
258237,img/Tribal_Print_V-Back_Kaftan/img_00000005.jpg,36,32,142,298,Kaftan,3,Full Body,106,266,28196,train,6
258240,img/Tribal_Print_V-Back_Kaftan/img_00000008.jpg,107,36,207,238,Kaftan,3,Full Body,100,202,20200,train,6
258242,img/Tribal_Print_V-Back_Kaftan/img_00000010.jpg,10,26,140,297,Kaftan,3,Full Body,130,271,35230,train,6
258243,img/Tribal_Print_V-Back_Kaftan/img_00000011.jpg,62,23,220,287,Kaftan,3,Full Body,158,264,41712,train,6
258244,img/Tribal_Print_V-Back_Kaftan/img_00000012.jpg,99,36,202,262,Kaftan,3,Full Body,103,226,23278,train,6
258245,img/Tribal_Print_V-Back_Kaftan/img_00000013.jpg,40,35,140,286,Kaftan,3,Full Body,100,251,25100,train,6
258246,img/Tribal_Print_V-Back_Kaftan/img_00000014.jpg,43,40,171,191,Kaftan,3,Full Body,128,151,19328,train,6
258247,img/Tribal_Print_V-Back_Kaftan/img_00000015.jpg,77,47,185,218,Kaftan,3,Full Body,108,171,18468,train,6
258249,img/Tribal_Print_V-Back_Kaftan/img_00000017.jpg,47,33,136,188,Kaftan,3,Full Body,89,155,13795,train,6
258250,img/Tribal_Print_V-Back_Kaftan/img_00000018.jpg,97,34,217,203,Kaftan,3,Full Body,120,169,20280,train,6
258251,img/Tribal_Print_V-Back_Kaftan/img_00000019.jpg,31,35,146,279,Kaftan,3,Full Body,115,244,28060,train,6
258252,img/Tribal_Print_V-Back_Kaftan/img_00000020.jpg,75,26,199,298,Kaftan,3,Full Body,124,272,33728,train,6
258253,img/Tribal_Print_V-Back_Kaftan/img_00000021.jpg,72,41,168,209,Kaftan,3,Full Body,96,168,16128,train,6
258254,img/Tribal_Print_V-Back_Kaftan/img_00000022.jpg,78,57,215,300,Kaftan,3,Full Body,137,243,33291,train,6
258256,img/Tribal_Print_V-Back_Kaftan/img_00000024.jpg,28,37,155,198,Kaftan,3,Full Body,127,161,20447,train,6
258257,img/Tribal_Print_V-Back_Kaftan/img_00000025.jpg,86,39,178,207,Kaftan,3,Full Body,92,168,15456,train,6
258258,img/Tribal_Print_V-Back_Kaftan/img_00000026.jpg,75,56,232,300,Kaftan,3,Full Body,157,244,38308,train,6
258259,img/Tribal_Print_V-Back_Kaftan/img_00000027.jpg,95,28,213,282,Kaftan,3,Full Body,118,254,29972,train,6
258261,img/Tribal_Print_V-Back_Kaftan/img_00000029.jpg,48,28,169,292,Kaftan,3,Full Body,121,264,31944,train,6
258262,img/Tribal_Print_V-Back_Kaftan/img_00000030.jpg,36,58,260,278,Kaftan,3,Full Body,224,220,49280,train,6
258263,img/Tribal_Print_V-Back_Kaftan/img_00000031.jpg,87,57,243,270,Kaftan,3,Full Body,156,213,33228,train,6
258265,img/Tribal_Print_V-Back_Kaftan/img_00000033.jpg,64,25,159,291,Kaftan,3,Full Body,95,266,25270,train,6
258268,img/Tribal_Print_V-Back_Kaftan/img_00000036.jpg,63,21,159,300,Kaftan,3,Full Body,96,279,26784,train,6
258271,img/Tribal_Print_V-Back_Kaftan/img_00000039.jpg,10,55,200,300,Kaftan,3,Full Body,190,245,46550,train,6
258272,img/Tribal_Print_V-Back_Kaftan/img_00000040.jpg,67,22,167,300,Kaftan,3,Full Body,100,278,27800,train,6
258273,img/Tribal_Print_V-Back_Kaftan/img_00000041.jpg,46,31,152,300,Kaftan,3,Full Body,106,269,28514,train,6
258274,img/Tribal_Print_V-Back_Kaftan/img_00000042.jpg,1,1,197,300,Kaftan,3,Full Body,196,299,58604,train,6
258275,img/Tribal_Print_V-Back_Kaftan/img_00000043.jpg,50,49,196,299,Kaftan,3,Full Body,146,250,36500,train,6
258276,img/Tribal_Print_V-Back_Kaftan/img_00000044.jpg,66,54,210,300,Kaftan,3,Full Body,144,246,35424,train,6
258278,img/Tribal_Print_V-Back_Kaftan/img_00000046.jpg,62,35,170,294,Kaftan,3,Full Body,108,259,27972,train,6
258279,img/Tribal_Print_V-Back_Kaftan/img_00000047.jpg,46,33,148,189,Kaftan,3,Full Body,102,156,15912,train,6
258280,img/Tribal_Print_V-Back_Kaftan/img_00000048.jpg,27,32,145,296,Kaftan,3,Full Body,118,264,31152,train,6
258281,img/Tribal_Print_V-Back_Kaftan/img_00000049.jpg,35,30,189,300,Kaftan,3,Full Body,154,270,41580,train,6
258282,img/Tribal_Print_V-Back_Kaftan/img_00000050.jpg,45,42,143,250,Kaftan,3,Full Body,98,208,20384,train,6
258284,img/Tribal_Print_V-Back_Kaftan/img_00000052.jpg,108,35,228,229,Kaftan,3,Full Body,120,194,23280,train,6
258285,img/Tribal_Print_V-Back_Kaftan/img_00000053.jpg,38,51,205,300,Kaftan,3,Full Body,167,249,41583,train,6
258286,img/Tribal_Print_V-Back_Kaftan/img_00000054.jpg,60,49,152,176,Kaftan,3,Full Body,92,127,11684,train,6
258289,img/Tribal_Print_V-Back_Kaftan/img_00000057.jpg,41,18,96,212,Kaftan,3,Full Body,55,194,10670,train,6
258290,img/Tribal_Print_V-Back_Kaftan/img_00000058.jpg,82,47,183,214,Kaftan,3,Full Body,101,167,16867,train,6
258291,img/Tribal_Print_V-Back_Kaftan/img_00000059.jpg,20,52,176,287,Kaftan,3,Full Body,156,235,36660,train,6
258292,img/Tribal_Print_V-Back_Kaftan/img_00000060.jpg,3,29,150,268,Kaftan,3,Full Body,147,239,35133,train,6
258293,img/Tribal_Print_V-Back_Kaftan/img_00000061.jpg,68,29,145,300,Kaftan,3,Full Body,77,271,20867,train,6
259377,img/Tonal_Plaid_Robe/img_00000001.jpg,51,20,143,219,Robe,3,Full Body,92,199,18308,train,9
259378,img/Tonal_Plaid_Robe/img_00000002.jpg,68,25,174,259,Robe,3,Full Body,106,234,24804,train,9
259379,img/Tonal_Plaid_Robe/img_00000003.jpg,21,30,142,278,Robe,3,Full Body,121,248,30008,train,9
259380,img/Tonal_Plaid_Robe/img_00000004.jpg,105,51,206,206,Robe,3,Full Body,101,155,15655,train,9
259381,img/Tonal_Plaid_Robe/img_00000005.jpg,29,19,171,239,Robe,3,Full Body,142,220,31240,train,9
259385,img/Tonal_Plaid_Robe/img_00000009.jpg,60,41,211,282,Robe,3,Full Body,151,241,36391,train,9
259388,img/Tonal_Plaid_Robe/img_00000012.jpg,55,14,144,181,Robe,3,Full Body,89,167,14863,train,9
259389,img/Tonal_Plaid_Robe/img_00000013.jpg,22,47,154,255,Robe,3,Full Body,132,208,27456,train,9
259390,img/Tonal_Plaid_Robe/img_00000014.jpg,49,86,158,249,Robe,3,Full Body,109,163,17767,train,9
259391,img/Tonal_Plaid_Robe/img_00000015.jpg,56,33,172,234,Robe,3,Full Body,116,201,23316,train,9
259392,img/Tonal_Plaid_Robe/img_00000016.jpg,27,34,145,243,Robe,3,Full Body,118,209,24662,train,9
259396,img/Tonal_Plaid_Robe/img_00000020.jpg,4,51,176,274,Robe,3,Full Body,172,223,38356,train,9
259397,img/Tonal_Plaid_Robe/img_00000021.jpg,1,1,300,300,Robe,3,Full Body,299,299,89401,train,9
259398,img/Tonal_Plaid_Robe/img_00000022.jpg,35,18,126,213,Robe,3,Full Body,91,195,17745,train,9
259857,img/Tonal_Plaid_Robe/img_00000023.jpg,1,1,200,300,Robe,3,Full Body,199,299,59501,train,9
259858,img/Tonal_Plaid_Robe/img_00000024.jpg,28,1,200,280,Robe,3,Full Body,172,279,47988,train,9
259859,img/Tonal_Plaid_Robe/img_00000025.jpg,30,56,181,300,Robe,3,Full Body,151,244,36844,train,9
259860,img/Tonal_Plaid_Robe/img_00000026.jpg,86,27,144,220,Robe,3,Full Body,58,193,11194,train,9
259861,img/Tonal_Plaid_Robe/img_00000027.jpg,1,37,180,220,Robe,3,Full Body,179,183,32757,train,9
259862,img/Tonal_Plaid_Robe/img_00000028.jpg,78,38,235,300,Robe,3,Full Body,157,262,41134,train,9
259864,img/Tonal_Plaid_Robe/img_00000030.jpg,1,43,180,220,Robe,3,Full Body,179,177,31683,train,9
259865,img/Tonal_Plaid_Robe/img_00000031.jpg,1,9,179,300,Robe,3,Full Body,178,291,51798,train,9
259866,img/Tonal_Plaid_Robe/img_00000032.jpg,28,34,164,250,Robe,3,Full Body,136,216,29376,train,9
259867,img/Tonal_Plaid_Robe/img_00000033.jpg,36,15,247,300,Robe,3,Full Body,211,285,60135,train,9
271542,img/Panda-Hood_Pajama_Onesie/img_00000001.jpg,25,34,127,300,Onesie,3,Full Body,102,266,27132,train,7
271543,img/Panda-Hood_Pajama_Onesie/img_00000002.jpg,69,60,211,261,Onesie,3,Full Body,142,201,28542,train,7
271544,img/Panda-Hood_Pajama_Onesie/img_00000003.jpg,69,95,215,242,Onesie,3,Full Body,146,147,21462,train,7
271545,img/Panda-Hood_Pajama_Onesie/img_00000004.jpg,54,30,133,300,Onesie,3,Full Body,79,270,21330,train,7
271550,img/Panda-Hood_Pajama_Onesie/img_00000009.jpg,62,41,186,296,Onesie,3,Full Body,124,255,31620,train,7
271552,img/Panda-Hood_Pajama_Onesie/img_00000011.jpg,64,32,160,295,Onesie,3,Full Body,96,263,25248,train,7
271555,img/Panda-Hood_Pajama_Onesie/img_00000014.jpg,124,47,280,280,Onesie,3,Full Body,156,233,36348,train,7
271556,img/Panda-Hood_Pajama_Onesie/img_00000015.jpg,62,1,190,289,Onesie,3,Full Body,128,288,36864,train,7
271557,img/Panda-Hood_Pajama_Onesie/img_00000016.jpg,1,20,300,300,Onesie,3,Full Body,299,280,83720,train,7
271559,img/Panda-Hood_Pajama_Onesie/img_00000018.jpg,43,56,139,284,Onesie,3,Full Body,96,228,21888,train,7
271560,img/Panda-Hood_Pajama_Onesie/img_00000019.jpg,56,58,162,300,Onesie,3,Full Body,106,242,25652,train,7
271561,img/Panda-Hood_Pajama_Onesie/img_00000020.jpg,154,44,260,300,Onesie,3,Full Body,106,256,27136,train,7
271563,img/Panda-Hood_Pajama_Onesie/img_00000022.jpg,1,21,300,300,Onesie,3,Full Body,299,279,83421,train,7
271565,img/Panda-Hood_Pajama_Onesie/img_00000024.jpg,1,99,300,288,Onesie,3,Full Body,299,189,56511,train,7
271566,img/Panda-Hood_Pajama_Onesie/img_00000025.jpg,20,13,187,234,Onesie,3,Full Body,167,221,36907,train,7
271567,img/Panda-Hood_Pajama_Onesie/img_00000026.jpg,52,31,160,286,Onesie,3,Full Body,108,255,27540,train,7
271568,img/Panda-Hood_Pajama_Onesie/img_00000027.jpg,106,57,209,300,Onesie,3,Full Body,103,243,25029,train,7
271569,img/Panda-Hood_Pajama_Onesie/img_00000028.jpg,150,60,295,246,Onesie,3,Full Body,145,186,26970,train,7
271570,img/Panda-Hood_Pajama_Onesie/img_00000029.jpg,137,40,288,299,Onesie,3,Full Body,151,259,39109,train,7
271571,img/Panda-Hood_Pajama_Onesie/img_00000030.jpg,41,18,166,300,Onesie,3,Full Body,125,282,35250,train,7
271572,img/Panda-Hood_Pajama_Onesie/img_00000031.jpg,1,98,204,300,Onesie,3,Full Body,203,202,41006,train,7
271574,img/Panda-Hood_Pajama_Onesie/img_00000033.jpg,42,31,144,284,Onesie,3,Full Body,102,253,25806,train,7
271576,img/Panda-Hood_Pajama_Onesie/img_00000035.jpg,1,88,300,300,Onesie,3,Full Body,299,212,63388,train,7
271577,img/Panda-Hood_Pajama_Onesie/img_00000036.jpg,44,44,181,289,Onesie,3,Full Body,137,245,33565,train,7
271578,img/Panda-Hood_Pajama_Onesie/img_00000037.jpg,28,25,106,217,Onesie,3,Full Body,78,192,14976,train,7
271579,img/Panda-Hood_Pajama_Onesie/img_00000038.jpg,35,52,180,281,Onesie,3,Full Body,145,229,33205,train,7
271580,img/Panda-Hood_Pajama_Onesie/img_00000039.jpg,25,33,212,289,Onesie,3,Full Body,187,256,47872,train,7
271581,img/Panda-Hood_Pajama_Onesie/img_00000040.jpg,1,1,155,300,Onesie,3,Full Body,154,299,46046,train,7
271582,img/Panda-Hood_Pajama_Onesie/img_00000041.jpg,1,48,300,300,Onesie,3,Full Body,299,252,75348,train,7
271583,img/Panda-Hood_Pajama_Onesie/img_00000042.jpg,92,13,217,299,Onesie,3,Full Body,125,286,35750,train,7
271584,img/Panda-Hood_Pajama_Onesie/img_00000043.jpg,101,18,253,300,Onesie,3,Full Body,152,282,42864,train,7
271585,img/Panda-Hood_Pajama_Onesie/img_00000044.jpg,31,16,149,281,Onesie,3,Full Body,118,265,31270,train,7
271590,img/Panda-Hood_Pajama_Onesie/img_00000049.jpg,51,101,164,266,Onesie,3,Full Body,113,165,18645,train,7
271591,img/Panda-Hood_Pajama_Onesie/img_00000050.jpg,41,31,156,300,Onesie,3,Full Body,115,269,30935,train,7
271593,img/Panda-Hood_Pajama_Onesie/img_00000052.jpg,1,32,147,288,Onesie,3,Full Body,146,256,37376,train,7
271594,img/Panda-Hood_Pajama_Onesie/img_00000053.jpg,138,45,259,300,Onesie,3,Full Body,121,255,30855,train,7
271595,img/Panda-Hood_Pajama_Onesie/img_00000054.jpg,11,30,124,283,Onesie,3,Full Body,113,253,28589,train,7
271596,img/Panda-Hood_Pajama_Onesie/img_00000055.jpg,3,44,141,272,Onesie,3,Full Body,138,228,31464,train,7
271597,img/Panda-Hood_Pajama_Onesie/img_00000056.jpg,33,25,185,300,Onesie,3,Full Body,152,275,41800,train,7
271598,img/Panda-Hood_Pajama_Onesie/img_00000057.jpg,50,35,151,298,Onesie,3,Full Body,101,263,26563,train,7
271599,img/Panda-Hood_Pajama_Onesie/img_00000058.jpg,29,20,139,300,Onesie,3,Full Body,110,280,30800,train,7
271600,img/Panda-Hood_Pajama_Onesie/img_00000059.jpg,121,145,210,296,Onesie,3,Full Body,89,151,13439,train,7
271601,img/Panda-Hood_Pajama_Onesie/img_00000060.jpg,105,9,220,291,Onesie,3,Full Body,115,282,32430,train,7
271602,img/Panda-Hood_Pajama_Onesie/img_00000061.jpg,160,122,216,196,Onesie,3,Full Body,56,74,4144,train,7
271603,img/Panda-Hood_Pajama_Onesie/img_00000062.jpg,1,60,300,299,Onesie,3,Full Body,299,239,71461,train,7
271605,img/Panda-Hood_Pajama_Onesie/img_00000064.jpg,25,50,176,285,Onesie,3,Full Body,151,235,35485,train,7
271610,img/Panda-Hood_Pajama_Onesie/img_00000069.jpg,42,5,188,288,Onesie,3,Full Body,146,283,41318,train,7
272113,img/Paisley_Print_Kaftan/img_00000003.jpg,1,1,215,300,Kaftan,3,Full Body,214,299,63986,train,6
272114,img/Paisley_Print_Kaftan/img_00000004.jpg,28,25,98,188,Kaftan,3,Full Body,70,163,11410,train,6
272115,img/Paisley_Print_Kaftan/img_00000005.jpg,32,1,267,300,Kaftan,3,Full Body,235,299,70265,train,6
272116,img/Paisley_Print_Kaftan/img_00000006.jpg,33,34,125,244,Kaftan,3,Full Body,92,210,19320,train,6
272117,img/Paisley_Print_Kaftan/img_00000007.jpg,21,1,123,293,Kaftan,3,Full Body,102,292,29784,train,6
272118,img/Paisley_Print_Kaftan/img_00000008.jpg,52,1,160,300,Kaftan,3,Full Body,108,299,32292,train,6
272119,img/Paisley_Print_Kaftan/img_00000009.jpg,33,1,277,300,Kaftan,3,Full Body,244,299,72956,train,6
272120,img/Paisley_Print_Kaftan/img_00000010.jpg,39,1,269,300,Kaftan,3,Full Body,230,299,68770,train,6
272122,img/Paisley_Print_Kaftan/img_00000012.jpg,155,49,300,300,Kaftan,3,Full Body,145,251,36395,train,6
272123,img/Paisley_Print_Kaftan/img_00000013.jpg,61,46,135,300,Kaftan,3,Full Body,74,254,18796,train,6
272124,img/Paisley_Print_Kaftan/img_00000014.jpg,1,1,200,300,Kaftan,3,Full Body,199,299,59501,train,6
272125,img/Paisley_Print_Kaftan/img_00000015.jpg,30,46,122,244,Kaftan,3,Full Body,92,198,18216,train,6
272126,img/Paisley_Print_Kaftan/img_00000016.jpg,1,3,300,300,Kaftan,3,Full Body,299,297,88803,train,6
272127,img/Paisley_Print_Kaftan/img_00000017.jpg,36,1,269,300,Kaftan,3,Full Body,233,299,69667,train,6
272128,img/Paisley_Print_Kaftan/img_00000018.jpg,15,15,181,292,Kaftan,3,Full Body,166,277,45982,train,6
272130,img/Paisley_Print_Kaftan/img_00000020.jpg,43,1,168,300,Kaftan,3,Full Body,125,299,37375,train,6
272131,img/Paisley_Print_Kaftan/img_00000021.jpg,72,8,244,300,Kaftan,3,Full Body,172,292,50224,train,6
272132,img/Paisley_Print_Kaftan/img_00000022.jpg,41,1,178,300,Kaftan,3,Full Body,137,299,40963,train,6
272133,img/Paisley_Print_Kaftan/img_00000023.jpg,1,1,225,300,Kaftan,3,Full Body,224,299,66976,train,6
272135,img/Paisley_Print_Kaftan/img_00000025.jpg,84,1,228,280,Kaftan,3,Full Body,144,279,40176,train,6
272136,img/Paisley_Print_Kaftan/img_00000026.jpg,1,1,211,300,Kaftan,3,Full Body,210,299,62790,train,6
272137,img/Paisley_Print_Kaftan/img_00000027.jpg,28,35,192,300,Kaftan,3,Full Body,164,265,43460,train,6
272138,img/Paisley_Print_Kaftan/img_00000028.jpg,38,1,270,300,Kaftan,3,Full Body,232,299,69368,train,6
272139,img/Paisley_Print_Kaftan/img_00000029.jpg,54,1,253,300,Kaftan,3,Full Body,199,299,59501,train,6
272140,img/Paisley_Print_Kaftan/img_00000030.jpg,95,32,203,203,Kaftan,3,Full Body,108,171,18468,train,6
272141,img/Paisley_Print_Kaftan/img_00000031.jpg,53,29,189,295,Kaftan,3,Full Body,136,266,36176,train,6
272142,img/Paisley_Print_Kaftan/img_00000032.jpg,39,1,193,271,Kaftan,3,Full Body,154,270,41580,train,6
272143,img/Paisley_Print_Kaftan/img_00000033.jpg,60,8,252,300,Kaftan,3,Full Body,192,292,56064,train,6
272145,img/Paisley_Print_Kaftan/img_00000035.jpg,15,1,295,300,Kaftan,3,Full Body,280,299,83720,train,6
272146,img/Paisley_Print_Kaftan/img_00000036.jpg,19,1,198,300,Kaftan,3,Full Body,179,299,53521,train,6
272147,img/Paisley_Print_Kaftan/img_00000037.jpg,92,10,236,228,Kaftan,3,Full Body,144,218,31392,train,6
272149,img/Paisley_Print_Kaftan/img_00000039.jpg,74,1,242,276,Kaftan,3,Full Body,168,275,46200,train,6
272150,img/Paisley_Print_Kaftan/img_00000040.jpg,59,26,187,297,Kaftan,3,Full Body,128,271,34688,train,6
272151,img/Paisley_Print_Kaftan/img_00000041.jpg,49,25,169,300,Kaftan,3,Full Body,120,275,33000,train,6
272152,img/Paisley_Print_Kaftan/img_00000042.jpg,26,36,156,262,Kaftan,3,Full Body,130,226,29380,train,6
272153,img/Paisley_Print_Kaftan/img_00000043.jpg,72,46,163,213,Kaftan,3,Full Body,91,167,15197,train,6
272154,img/Paisley_Print_Kaftan/img_00000044.jpg,43,11,161,185,Kaftan,3,Full Body,118,174,20532,train,6
272157,img/Paisley_Print_Kaftan/img_00000047.jpg,16,1,160,300,Kaftan,3,Full Body,144,299,43056,train,6
272158,img/Paisley_Print_Kaftan/img_00000048.jpg,80,7,140,300,Kaftan,3,Full Body,60,293,17580,train,6
272160,img/Paisley_Print_Kaftan/img_00000050.jpg,20,1,286,300,Kaftan,3,Full Body,266,299,79534,train,6
272161,img/Paisley_Print_Kaftan/img_00000051.jpg,61,1,164,300,Kaftan,3,Full Body,103,299,30797,train,6
272162,img/Paisley_Print_Kaftan/img_00000052.jpg,51,37,146,256,Kaftan,3,Full Body,95,219,20805,train,6
272164,img/Paisley_Print_Kaftan/img_00000054.jpg,11,1,174,230,Kaftan,3,Full Body,163,229,37327,train,6
272165,img/Paisley_Print_Kaftan/img_00000055.jpg,1,1,300,300,Kaftan,3,Full Body,299,299,89401,train,6
272166,img/Paisley_Print_Kaftan/img_00000056.jpg,46,1,156,300,Kaftan,3,Full Body,110,299,32890,train,6
272167,img/Paisley_Print_Kaftan/img_00000057.jpg,63,1,172,300,Kaftan,3,Full Body,109,299,32591,train,6
272168,img/Paisley_Print_Kaftan/img_00000058.jpg,15,1,286,300,Kaftan,3,Full Body,271,299,81029,train,6
272169,img/Paisley_Print_Kaftan/img_00000059.jpg,1,6,149,265,Kaftan,3,Full Body,148,259,38332,train,6
272170,img/Paisley_Print_Kaftan/img_00000060.jpg,1,31,83,244,Kaftan,3,Full Body,82,213,17466,train,6
272172,img/Paisley_Print_Kaftan/img_00000062.jpg,15,1,139,259,Kaftan,3,Full Body,124,258,31992,train,6
272173,img/Paisley_Print_Kaftan/img_00000063.jpg,39,24,197,300,Kaftan,3,Full Body,158,276,43608,train,6
272174,img/Paisley_Print_Kaftan/img_00000064.jpg,67,1,241,296,Kaftan,3,Full Body,174,295,51330,train,6
